FIPS Codes,County Name,State Name,Population 25 years and over,Population 25 years and over!Less than 9th grade,"Population 25 years and over!9th to 12th grade, no diploma",Population 25 years and over!High school graduate (includes equivalency),"Population 25 years and over!Some college, no degree",Population 25 years and over!Associate's degree,Population 25 years and over!Bachelor's degree,Population 25 years and over!Graduate or professional degree,Population 25 years and over!Cumulative!High school graduate or higher,Population 25 years and over!Cumulative!Bachelor's degree or higher
01001,Autauga County,Alabama,40188,694,3163,12517,8440,3495,6726,5153,36331,11879
01003,Baldwin County,Alabama,167022,3350,10681,46391,36169,16046,33474,20911,152991,54385
01005,Barbour County,Alabama,17675,1289,2866,6507,3516,1397,1167,933,13520,2100
01007,Bibb County,Alabama,15925,1018,2348,6510,3041,1269,1047,692,12559,1739
01009,Blount County,Alabama,40817,2908,4539,14414,8446,4493,3840,2177,33370,6017
01011,Bullock County,Alabama,7156,710,1195,2957,1397,226,492,179,5251,671
01013,Butler County,Alabama,13266,513,1133,6364,2538,987,1029,702,11620,1731
01015,Calhoun County,Alabama,78931,3494,8289,27278,18351,6401,9098,6020,67148,15118
01017,Chambers County,Alabama,24706,1423,2664,9763,5013,2697,2273,873,20619,3146
01019,Cherokee County,Alabama,18523,1225,2123,6678,3579,2215,1530,1173,15175,2703
01021,Chilton County,Alabama,30609,1810,3650,12737,5838,2297,2504,1773,25149,4277
01023,Choctaw County,Alabama,9052,580,1014,3460,1942,875,873,308,7458,1181
01025,Clarke County,Alabama,16015,779,2201,6569,3143,1118,1346,859,13035,2205
01027,Clay County,Alabama,10053,504,1171,3761,2146,1188,926,357,8378,1283
01029,Cleburne County,Alabama,10630,549,1306,4145,2071,806,1172,581,8775,1753
01031,Coffee County,Alabama,36556,1646,3245,10581,8404,4781,4786,3113,31665,7899
01033,Colbert County,Alabama,40835,1453,4108,14960,9499,3447,4578,2790,35274,7368
01035,Conecuh County,Alabama,8382,239,647,4046,1656,678,642,474,7496,1116
01037,Coosa County,Alabama,8049,300,1029,3334,1781,749,578,278,6720,856
01039,Covington County,Alabama,26447,1171,2596,9593,5648,3126,2585,1728,22680,4313
01041,Crenshaw County,Alabama,9148,623,1017,3885,1320,730,1092,481,7508,1573
01043,Cullman County,Alabama,61520,2823,6643,19297,14489,7012,7463,3793,52054,11256
01045,Dale County,Alabama,33687,1526,3304,10554,8444,3404,4360,2095,28857,6455
01047,Dallas County,Alabama,25984,894,2923,10304,5033,2752,2633,1445,22167,4078
01049,DeKalb County,Alabama,48385,5384,5393,15375,9990,5397,3996,2850,37608,6846
01051,Elmore County,Alabama,61046,2073,4919,20640,12630,6035,9637,5112,54054,14749
01053,Escambia County,Alabama,25461,1159,3356,11293,4297,2159,2168,1029,20946,3197
01055,Etowah County,Alabama,72715,2921,7173,24304,17578,7854,7840,5045,62621,12885
01057,Fayette County,Alabama,11428,734,1124,4551,2638,895,943,543,9570,1486
01059,Franklin County,Alabama,21351,1297,2952,8571,3859,1506,2204,962,17102,3166
01061,Geneva County,Alabama,18982,1195,1956,6960,4137,2093,1842,799,15831,2641
01063,Greene County,Alabama,5449,151,836,2023,1112,416,579,332,4462,911
01065,Hale County,Alabama,9980,514,1425,3768,1748,891,1079,555,8041,1634
01067,Henry County,Alabama,12561,725,1595,4121,2343,1144,1758,875,10241,2633
01069,Houston County,Alabama,73993,2667,6497,23675,17354,7181,10616,6003,64829,16619
01071,Jackson County,Alabama,37823,1962,4833,14144,7262,3499,3874,2249,31028,6123
01073,Jefferson County,Alabama,457310,11324,29544,119359,97047,37364,96805,65867,416442,162672
01075,Lamar County,Alabama,9894,689,1085,4043,2033,1031,606,407,8120,1013
01077,Lauderdale County,Alabama,64564,1907,5332,22507,12918,5226,10372,6302,57325,16674
01079,Lawrence County,Alabama,23478,1343,2727,9660,4340,1703,2364,1341,19408,3705
01081,Lee County,Alabama,107084,2599,6276,23274,22028,9899,23707,19301,98209,43008
01083,Limestone County,Alabama,73067,3141,6119,20320,15286,6624,13776,7801,63807,21577
01085,Lowndes County,Alabama,7035,337,836,2925,1077,712,739,409,5862,1148
01087,Macon County,Alabama,11880,448,1605,3763,2736,886,1275,1167,9827,2442
01089,Madison County,Alabama,267305,5974,14810,50873,54737,20395,71617,48899,246521,120516
01091,Marengo County,Alabama,12997,402,1014,4633,2840,1254,1654,1200,11581,2854
01093,Marion County,Alabama,20785,1274,2754,7376,4509,2413,1476,983,16757,2459
01095,Marshall County,Alabama,64995,4245,5916,20737,13105,7069,9437,4486,54834,13923
01097,Mobile County,Alabama,279868,7807,25403,95565,58791,24551,43806,23945,246658,67751
01099,Monroe County,Alabama,13707,476,1759,6035,2395,1190,1072,780,11472,1852
01101,Montgomery County,Alabama,151442,5431,12791,38816,31896,11506,29456,21546,133220,51002
01103,Morgan County,Alabama,84874,5067,7468,26134,18357,7608,13494,6746,72339,20240
01105,Perry County,Alabama,5314,352,733,2280,856,284,537,272,4229,809
01107,Pickens County,Alabama,13592,874,1172,5588,2735,1251,1229,743,11546,1972
01109,Pike County,Alabama,19205,590,1734,6957,3558,1044,3024,2298,16881,5322
01111,Randolph County,Alabama,15614,945,1863,5443,2872,1555,1892,1044,12806,2936
01113,Russell County,Alabama,39868,2186,3718,11794,10353,5293,4088,2436,33964,6524
01115,St. Clair County,Alabama,64523,2618,5585,22916,14983,5950,8608,3863,56320,12471
01117,Shelby County,Alabama,153645,3054,6483,30961,30914,12165,45813,24255,144108,70068
01119,Sumter County,Alabama,7354,187,636,2369,2040,522,901,699,6531,1600
01121,Talladega County,Alabama,57406,2604,7033,20033,13701,4504,5623,3908,47769,9531
01123,Tallapoosa County,Alabama,29557,1518,3838,9493,6687,2656,3380,1985,24201,5365
01125,Tuscaloosa County,Alabama,141959,3594,9693,41754,30365,12721,25838,17994,128672,43832
01127,Walker County,Alabama,45281,2387,5462,15772,9773,4964,4268,2655,37432,6923
01129,Washington County,Alabama,10500,293,939,4601,2387,787,707,786,9268,1493
01131,Wilcox County,Alabama,7069,401,1175,2855,1450,367,554,267,5493,821
01133,Winston County,Alabama,16998,1005,2388,6859,3128,1268,1384,966,13605,2350
02013,Aleutians East Borough,Alaska,2675,262,246,1053,499,162,339,114,2167,453
02016,Aleutians West Census Area,Alaska,3861,241,163,1596,974,291,508,88,3457,596
02020,Anchorage Municipality,Alaska,192454,3986,7216,47155,46340,16483,44340,26934,181252,71274
02050,Bethel Census Area,Alaska,10109,635,1110,4838,1808,738,532,448,8364,980
02060,Bristol Bay Borough,Alaska,636,13,19,180,203,54,139,28,604,167
02063,Chugach Census Area,Alaska,4929,88,181,1172,1368,569,1001,550,4660,1551
02066,Copper River Census Area,Alaska,1791,37,99,521,517,114,341,162,1655,503
02068,Denali Borough,Alaska,1674,19,37,784,273,140,229,192,1618,421
02070,Dillingham Census Area,Alaska,2902,120,225,1206,567,190,329,265,2557,594
02090,Fairbanks North Star Borough,Alaska,61350,1138,2133,15512,16407,5948,12039,8173,58079,20212
02100,Haines Borough,Alaska,1420,11,22,489,357,63,238,240,1387,478
02105,Hoonah-Angoon Census Area,Alaska,1838,13,97,618,427,177,375,131,1728,506
02110,Juneau City and Borough,Alaska,22947,238,808,5071,5366,2116,5922,3426,21901,9348
02122,Kenai Peninsula Borough,Alaska,41645,663,1741,12839,11032,3723,7313,4334,39241,11647
02130,Ketchikan Gateway Borough,Alaska,9869,112,407,2814,3076,648,1908,904,9350,2812
02150,Kodiak Island Borough,Alaska,8634,368,389,2507,2093,819,1655,803,7877,2458
02158,Kusilvak Census Area,Alaska,4052,157,596,2256,739,118,161,25,3299,186
02164,Lake and Peninsula Borough,Alaska,651,25,35,293,150,47,56,45,591,101
02170,Matanuska-Susitna Borough,Alaska,71369,1247,2876,23675,18776,7913,10907,5975,67246,16882
02180,Nome Census Area,Alaska,5564,182,473,2415,1287,188,433,586,4909,1019
02185,North Slope Borough,Alaska,7601,212,497,3272,1876,665,725,354,6892,1079
02188,Northwest Arctic Borough,Alaska,4230,173,417,1954,868,177,425,216,3640,641
02195,Petersburg Borough,Alaska,2537,221,110,807,567,203,448,181,2206,629
02198,Prince of Wales-Hyder Census Area,Alaska,4151,54,259,1509,1168,356,566,239,3838,805
02220,Sitka City and Borough,Alaska,6071,122,168,1564,1543,598,1391,685,5781,2076
02230,Skagway Municipality,Alaska,970,51,20,330,237,62,214,56,899,270
02240,Southeast Fairbanks Census Area,Alaska,4534,93,191,1660,1262,431,622,275,4250,897
02275,Wrangell City and Borough,Alaska,1559,27,174,521,406,150,217,64,1358,281
02282,Yakutat City and Borough,Alaska,397,4,20,173,116,41,38,5,373,43
02290,Yukon-Koyukuk Census Area,Alaska,3451,151,297,1342,1000,173,333,155,3003,488
04001,Apache County,Arizona,42220,2963,3788,13702,12059,3889,3475,2344,35469,5819
04003,Cochise County,Arizona,88211,4028,5752,22178,22609,10095,14684,8865,78431,23549
04005,Coconino County,Arizona,86631,2851,4555,18231,19259,7435,20215,14085,79225,34300
04007,Gila County,Arizona,39673,1056,4044,12125,11221,4052,4700,2475,34573,7175
04009,Graham County,Arizona,24362,1047,2699,7410,7099,2708,2192,1207,20616,3399
04011,Greenlee County,Arizona,5854,280,543,1896,1751,408,774,202,5031,976
04012,La Paz County,Arizona,13188,789,1504,4331,3759,1172,1103,530,10895,1633
04013,Maricopa County,Arizona,2987215,146687,176663,659517,689799,269476,655112,389961,2663865,1045073
04015,Mohave County,Arizona,165754,5844,14419,57089,49062,15461,14796,9083,145491,23879
04017,Navajo County,Arizona,70604,3508,6629,21076,20167,7016,7133,5075,60467,12208
04019,Pima County,Arizona,705718,29710,44588,151393,170987,62151,140892,105997,631420,246889
04021,Pinal County,Arizona,302970,13418,21533,93064,79454,30651,43734,21116,268019,64850
04023,Santa Cruz County,Arizona,30749,3080,3693,7797,6161,2791,4308,2919,23976,7227
04025,Yavapai County,Arizona,184475,3912,10576,46852,52840,17388,31291,21616,169987,52907
04027,Yuma County,Arizona,131335,16321,14952,34719,32600,11173,14038,7532,100062,21570
05001,Arkansas County,Arkansas,11889,512,1156,5049,1817,1479,1237,639,10221,1876
05003,Ashley County,Arkansas,13222,736,1132,6404,2616,803,1090,441,11354,1531
05005,Baxter County,Arkansas,31982,759,2559,11247,7880,3729,4004,1804,28664,5808
05007,Benton County,Arkansas,188577,9107,9516,54279,35606,13109,43246,23714,169954,66960
05009,Boone County,Arkansas,26260,809,1658,9168,7345,2913,2892,1475,23793,4367
05011,Bradley County,Arkansas,7105,362,644,3347,1421,440,620,271,6099,891
05013,Calhoun County,Arkansas,3462,81,428,1571,645,303,266,168,2953,434
05015,Carroll County,Arkansas,20180,1668,1200,7238,4154,1593,2932,1395,17312,4327
05017,Chicot County,Arkansas,7065,413,1025,2675,1368,339,889,356,5627,1245
05019,Clark County,Arkansas,12424,406,870,3876,3264,722,2161,1125,11148,3286
05021,Clay County,Arkansas,10342,608,1016,4255,1997,875,898,693,8718,1591
05023,Cleburne County,Arkansas,18612,810,1441,7328,4117,1717,2123,1076,16361,3199
05025,Cleveland County,Arkansas,5413,49,391,2369,1468,277,546,313,4973,859
05027,Columbia County,Arkansas,14189,502,1157,5888,3005,943,1884,810,12530,2694
05029,Conway County,Arkansas,14483,544,1019,6258,2559,1330,2044,729,12920,2773
05031,Craighead County,Arkansas,71091,3154,3829,23522,14987,5547,12275,7777,64108,20052
05033,Crawford County,Arkansas,41093,1720,4251,14144,9184,3445,5977,2372,35122,8349
05035,Crittenden County,Arkansas,30572,1450,2959,11110,7132,2532,3808,1581,26163,5389
05037,Cross County,Arkansas,11566,679,1233,4938,2011,847,1235,623,9654,1858
05039,Dallas County,Arkansas,4671,179,361,2261,969,292,408,201,4131,609
05041,Desha County,Arkansas,7691,748,869,3359,1518,192,636,369,6074,1005
05043,Drew County,Arkansas,10906,347,1031,3928,2170,701,1856,873,9528,2729
05045,Faulkner County,Arkansas,77167,2278,3093,22930,17480,6323,15574,9489,71796,25063
05047,Franklin County,Arkansas,12025,549,1105,5117,2621,1154,1051,428,10371,1479
05049,Fulton County,Arkansas,8708,424,719,3323,2365,624,830,423,7565,1253
05051,Garland County,Arkansas,72911,1817,5007,22727,17781,7172,11550,6857,66087,18407
05053,Grant County,Arkansas,12609,281,647,5377,2964,972,1730,638,11681,2368
05055,Greene County,Arkansas,30946,1071,2668,13747,6278,2057,3283,1842,27207,5125
05057,Hempstead County,Arkansas,13301,1019,1124,5201,2794,1063,1279,821,11158,2100
05059,Hot Spring County,Arkansas,24022,627,2126,9452,6074,2019,2420,1304,21269,3724
05061,Howard County,Arkansas,8505,366,619,3648,1785,813,844,430,7520,1274
05063,Independence County,Arkansas,25382,1004,2334,9802,5817,2083,2948,1394,22044,4342
05065,Izard County,Arkansas,10452,475,1276,3608,2357,757,1391,588,8701,1979
05067,Jackson County,Arkansas,11927,508,1131,5317,2663,894,927,487,10288,1414
05069,Jefferson County,Arkansas,45704,1512,3477,19330,9739,2436,6384,2826,40715,9210
05071,Johnson County,Arkansas,17235,1485,1880,7063,3351,864,1771,821,13870,2592
05073,Lafayette County,Arkansas,4514,422,433,2185,735,260,324,155,3659,479
05075,Lawrence County,Arkansas,10950,652,1289,4111,2698,782,957,461,9009,1418
05077,Lee County,Arkansas,6193,271,750,3051,1284,360,394,83,5172,477
05079,Lincoln County,Arkansas,10007,562,1091,5078,2013,449,547,267,8354,814
05081,Little River County,Arkansas,8415,175,618,3826,1778,678,974,366,7622,1340
05083,Logan County,Arkansas,15192,491,1309,6635,3363,1215,1379,800,13392,2179
05085,Lonoke County,Arkansas,49756,1560,3481,18472,11060,5267,6608,3308,44715,9916
05087,Madison County,Arkansas,11654,535,1217,5766,2194,507,973,462,9902,1435
05089,Marion County,Arkansas,12875,561,1018,4792,3481,1062,1161,800,11296,1961
05091,Miller County,Arkansas,28953,1247,2609,11006,7388,2186,2614,1903,25097,4517
05093,Mississippi County,Arkansas,26228,1782,2723,10478,5411,1952,2413,1469,21723,3882
05095,Monroe County,Arkansas,4771,336,609,1961,892,296,468,209,3826,677
05097,Montgomery County,Arkansas,6467,312,545,2266,1741,543,760,300,5610,1060
05099,Nevada County,Arkansas,5657,260,328,2817,1184,449,476,143,5069,619
05101,Newton County,Arkansas,5236,199,590,1943,1318,412,494,280,4447,774
05103,Ouachita County,Arkansas,15755,323,1542,6270,4065,1199,1573,783,13890,2356
05105,Perry County,Arkansas,7152,245,398,3183,1804,435,782,305,6509,1087
05107,Phillips County,Arkansas,10670,619,1302,3334,2506,1283,1021,605,8749,1626
05109,Pike County,Arkansas,7133,486,322,2831,1651,523,866,454,6325,1320
05111,Poinsett County,Arkansas,15626,1282,1563,7326,2945,706,1297,507,12781,1804
05113,Polk County,Arkansas,13516,441,1176,4873,3822,1005,1513,686,11899,2199
05115,Pope County,Arkansas,41041,2243,3791,13938,8358,2910,6437,3364,35007,9801
05117,Prairie County,Arkansas,5994,392,472,2516,1272,384,596,362,5130,958
05119,Pulaski County,Arkansas,270873,7673,13849,68504,58462,22050,59004,41331,249351,100335
05121,Randolph County,Arkansas,12793,681,935,5177,2713,1298,1248,741,11177,1989
05123,St. Francis County,Arkansas,16284,825,1741,6823,3556,1178,1213,948,13718,2161
05125,Saline County,Arkansas,86181,2264,4704,26714,19938,8036,16876,7649,79213,24525
05127,Scott County,Arkansas,6909,424,693,2880,1500,580,638,194,5792,832
05129,Searcy County,Arkansas,5734,423,610,2244,1148,452,637,220,4701,857
05131,Sebastian County,Arkansas,85873,5552,7299,25929,20154,6397,12935,7607,73022,20542
05133,Sevier County,Arkansas,9814,1400,1198,3406,1823,842,764,381,7216,1145
05135,Sharp County,Arkansas,12611,509,1436,5161,3245,808,946,506,10666,1452
05137,Stone County,Arkansas,9080,364,895,3222,2211,1077,847,464,7821,1311
05139,Union County,Arkansas,26493,804,2587,10111,5861,2236,3250,1644,23102,4894
05141,Van Buren County,Arkansas,11769,655,1177,4743,2411,811,1229,743,9937,1972
05143,Washington County,Arkansas,151212,10710,8947,41829,27802,9809,30466,21649,131555,52115
05145,White County,Arkansas,50533,2150,4750,20266,8594,4422,6067,4284,43633,10351
05147,Woodruff County,Arkansas,4387,184,500,2105,504,370,375,349,3703,724
05149,Yell County,Arkansas,13857,1220,1914,5247,2637,926,1306,607,10723,1913
06001,Alameda County,California,1193888,70927,57859,193986,187117,75864,343246,264889,1065102,608135
06003,Alpine County,California,1068,44,28,215,257,101,248,175,996,423
06005,Amador County,California,31901,830,2202,9196,8665,4448,4598,1962,28869,6560
06007,Butte County,California,138986,4854,8614,31050,37211,14403,28092,14762,125518,42854
06009,Calaveras County,California,35412,550,2087,11074,10330,3794,5150,2427,32775,7577
06011,Colusa County,California,14021,2530,1217,4115,2731,1425,1530,473,10274,2003
06013,Contra Costa County,California,808485,42552,40583,142073,156636,66886,219701,140054,725350,359755
06015,Del Norte County,California,19672,954,2351,5507,5512,1863,2193,1292,16367,3485
06017,El Dorado County,California,140802,2909,4511,29026,35447,15471,35536,17902,133382,53438
06019,Fresno County,California,624392,75992,59783,142037,144541,56032,96794,49213,488617,146007
06021,Glenn County,California,18475,2439,1661,5787,4256,1585,2120,627,14375,2747
06023,Humboldt County,California,93612,2345,5832,22150,25059,9128,19011,10087,85435,29098
06025,Imperial County,California,110201,15742,15918,27884,24757,8360,13008,4532,78541,17540
06027,Inyo County,California,13867,388,574,3876,3744,1270,2406,1609,12905,4015
06029,Kern County,California,553334,71055,58701,151801,127047,43359,66940,34431,423578,101371
06031,Kings County,California,95084,12591,11669,25683,22540,8600,9541,4460,70824,14001
06033,Lake County,California,48945,2397,4145,13920,13621,5948,5943,2971,42403,8914
06035,Lassen County,California,23744,1308,3328,7585,6505,2146,2138,734,19108,2872
06037,Los Angeles County,California,6909650,811822,552831,1412260,1260211,482967,1542422,847137,5544997,2389559
06039,Madera County,California,99045,16370,11310,22910,23947,7521,11497,5490,71365,16987
06041,Marin County,California,191565,7847,4761,19805,29935,12117,65256,51844,178957,117100
06043,Mariposa County,California,13371,292,797,2911,4069,1434,2607,1261,12282,3868
06045,Mendocino County,California,65163,4046,4574,16640,18023,6249,9382,6249,56543,15631
06047,Merced County,California,168503,28282,19840,46826,35935,12943,17165,7512,120381,24677
06049,Modoc County,California,6511,328,435,1915,1725,557,1062,489,5748,1551
06051,Mono County,California,9628,622,614,1918,2421,1000,1897,1156,8392,3053
06053,Monterey County,California,279734,48086,26425,57115,49127,23268,45473,30240,205223,75713
06055,Napa County,California,98232,9672,5655,17071,20093,8571,24039,13131,82905,37170
06057,Nevada County,California,79007,1253,2636,15698,20904,7854,19803,10859,75118,30662
06059,Orange County,California,2197677,160388,129070,379318,421273,167810,591937,347881,1908219,939818
06061,Placer County,California,286915,5636,8860,49819,68576,32254,79373,42397,272419,121770
06063,Plumas County,California,15236,331,568,4184,5382,1544,2227,1000,14337,3227
06065,Riverside County,California,1594000,142806,126225,426917,378021,136585,244893,138553,1324969,383446
06067,Sacramento County,California,1077155,65448,59760,236025,259317,105201,227553,123851,951947,351404
06069,San Benito County,California,42300,4193,2706,11226,10332,4538,6667,2638,35401,9305
06071,San Bernardino County,California,1388742,117765,140623,378034,323816,117124,201183,110197,1130354,311380
06073,San Diego County,California,2257620,136101,118736,409287,477938,188877,564011,362670,2002783,926681
06075,San Francisco County,California,680343,46756,29521,78800,82698,35794,238669,168105,604066,406774
06077,San Joaquin County,California,495879,56510,41515,140587,110066,46503,68376,32322,397854,100698
06079,San Luis Obispo County,California,189527,6383,8683,35358,47470,19666,45318,26649,174461,71967
06081,San Mateo County,California,547817,30317,21281,81357,87450,37733,161021,128658,496219,289679
06083,Santa Barbara County,California,277891,31454,18246,47882,57632,23534,59212,39931,228191,99143
06085,Santa Clara County,California,1341405,84932,58824,180686,185266,89525,377331,364841,1197649,742172
06087,Santa Cruz County,California,180171,12950,7391,28468,39876,14949,44286,32251,159830,76537
06089,Shasta County,California,128883,2644,7801,33226,40425,15460,19783,9544,118438,29327
06091,Sierra County,California,2249,64,81,743,634,190,265,272,2104,537
06093,Siskiyou County,California,32134,1173,1862,8681,9242,4107,4772,2297,29099,7069
06095,Solano County,California,312706,17255,17522,74321,82550,32876,60316,27866,277929,88182
06097,Sonoma County,California,354851,20899,17291,64140,84726,33496,82815,51484,316661,134299
06099,Stanislaus County,California,350685,38168,30813,105597,84620,27600,44136,19751,281704,63887
06101,Sutter County,California,64986,6784,6503,15665,16103,6529,9068,4334,51699,13402
06103,Tehama County,California,44986,2426,3385,13531,12805,4665,5951,2223,39175,8174
06105,Trinity County,California,12553,176,420,5599,3198,752,1463,945,11957,2408
06107,Tulare County,California,280911,46776,27683,74036,62841,25705,28337,15533,206452,43870
06109,Tuolumne County,California,42078,692,2481,10373,13606,4643,6941,3342,38905,10283
06111,Ventura County,California,575974,50005,34261,113287,120206,58278,125787,74150,491708,199937
06113,Yolo County,California,129126,9100,6552,23213,24707,9680,28888,26986,113474,55874
06115,Yuba County,California,51600,4142,4804,13105,15116,5476,5915,3042,42654,8957
08001,Adams County,Colorado,338792,23482,27965,97401,69215,28736,62602,29391,287345,91993
08003,Alamosa County,Colorado,9807,550,449,2713,2470,858,1551,1216,8808,2767
08005,Arapahoe County,Colorado,450081,16127,19030,87270,87564,37906,125322,76862,414924,202184
08007,Archuleta County,Colorado,10417,153,418,2495,2656,587,2539,1569,9846,4108
08009,Baca County,Colorado,2504,109,246,771,507,261,444,166,2149,610
08011,Bent County,Colorado,4265,195,513,1837,706,353,410,251,3557,661
08013,Boulder County,Colorado,217821,4191,5111,24500,32527,13763,75431,62298,208519,137729
08014,Broomfield County,Colorado,52126,545,1404,6517,8383,4845,18430,12002,50177,30432
08015,Chaffee County,Colorado,15510,374,705,3837,2926,1243,3738,2687,14431,6425
08017,Cheyenne County,Colorado,1225,27,59,384,342,126,196,91,1139,287
08019,Clear Creek County,Colorado,7643,83,175,1429,1271,479,2202,2004,7385,4206
08021,Conejos County,Colorado,4978,237,272,1645,1173,424,818,409,4469,1227
08023,Costilla County,Colorado,2617,152,153,795,714,184,441,178,2312,619
08025,Crowley County,Colorado,4191,284,511,1837,695,330,387,147,3396,534
08027,Custer County,Colorado,3787,22,94,796,1144,350,853,528,3671,1381
08029,Delta County,Colorado,22899,683,1606,8381,5088,1531,3710,1900,20610,5610
08031,Denver County,Colorado,519431,23672,25422,79953,80809,27791,172213,109571,470337,281784
08033,Dolores County,Colorado,1907,36,54,756,423,136,300,202,1817,502
08035,Douglas County,Colorado,243113,2256,2867,29102,43957,19052,94158,51721,237990,145879
08037,Eagle County,Colorado,40007,1640,1402,6722,5780,3737,14027,6699,36965,20726
08039,Elbert County,Colorado,19030,259,366,4710,4731,2186,4850,1928,18405,6778
08041,El Paso County,Colorado,478864,8879,16016,94713,113904,52941,117443,74968,453969,192411
08043,Fremont County,Colorado,38046,1023,2843,14596,8680,3210,5340,2354,34180,7694
08045,Garfield County,Colorado,41298,2189,2230,10006,9193,3765,8965,4950,36879,13915
08047,Gilpin County,Colorado,4658,15,244,777,965,613,973,1071,4399,2044
08049,Grand County,Colorado,12048,209,434,3399,2652,797,2648,1909,11405,4557
08051,Gunnison County,Colorado,11260,88,101,1912,1819,658,4652,2030,11071,6682
08053,Hinsdale County,Colorado,787,0,12,113,268,43,197,154,775,351
08055,Huerfano County,Colorado,5162,218,148,1341,1495,614,847,499,4796,1346
08057,Jackson County,Colorado,1076,40,114,273,253,100,174,122,922,296
08059,Jefferson County,Colorado,424697,6332,13933,81385,81535,32861,132350,76301,404432,208651
08061,Kiowa County,Colorado,930,11,71,264,292,125,117,50,848,167
08063,Kit Carson County,Colorado,4798,236,352,1432,1404,508,578,288,4210,866
08065,Lake County,Colorado,5276,220,82,1391,914,599,1245,825,4974,2070
08067,La Plata County,Colorado,40389,454,1228,8619,7852,3268,12325,6643,38707,18968
08069,Larimer County,Colorado,239134,2912,5872,39944,47475,21243,73222,48466,230350,121688
08071,Las Animas County,Colorado,10599,534,685,2870,3143,1613,1069,685,9380,1754
08073,Lincoln County,Colorado,4203,69,404,1737,692,345,766,190,3730,956
08075,Logan County,Colorado,15042,333,1010,5641,3236,1856,1791,1175,13699,2966
08077,Mesa County,Colorado,109465,2102,6352,31580,27491,9065,22061,10814,101011,32875
08079,Mineral County,Colorado,685,0,15,108,131,36,278,117,670,395
08081,Moffat County,Colorado,9006,100,683,3726,1717,930,1333,517,8223,1850
08083,Montezuma County,Colorado,18740,390,1239,5814,3989,1674,3328,2306,17111,5634
08085,Montrose County,Colorado,31003,1618,1698,10284,6847,1963,5769,2824,27687,8593
08087,Morgan County,Colorado,18881,1839,1435,5990,4492,1777,2194,1154,15607,3348
08089,Otero County,Colorado,12641,475,1037,4120,2973,1720,1399,917,11129,2316
08091,Ouray County,Colorado,4175,28,78,572,1046,382,1275,794,4069,2069
08093,Park County,Colorado,14180,122,224,3274,3991,1537,3305,1727,13834,5032
08095,Phillips County,Colorado,2966,131,192,873,673,318,572,207,2643,779
08097,Pitkin County,Colorado,13499,45,202,1894,1791,1048,5045,3474,13252,8519
08099,Prowers County,Colorado,7543,620,475,2354,1845,873,777,599,6448,1376
08101,Pueblo County,Colorado,115954,4000,7554,34213,27992,14287,18044,9864,104400,27908
08103,Rio Blanco County,Colorado,4343,86,251,1513,1056,403,711,323,4006,1034
08105,Rio Grande County,Colorado,8092,409,393,2306,1856,597,1693,838,7290,2531
08107,Routt County,Colorado,18742,179,390,3409,3617,1768,5931,3448,18173,9379
08109,Saguache County,Colorado,4901,270,296,1547,1155,438,627,568,4335,1195
08111,San Juan County,Colorado,552,24,0,169,108,21,134,96,528,230
08113,San Miguel County,Colorado,6282,17,97,1116,854,293,2874,1031,6168,3905
08115,Sedgwick County,Colorado,1718,34,115,443,388,283,309,146,1569,455
08117,Summit County,Colorado,24050,557,830,4045,4863,1187,7876,4692,22663,12568
08119,Teller County,Colorado,19324,74,497,4238,5069,2110,4448,2888,18753,7336
08121,Washington County,Colorado,3370,101,218,956,851,419,561,264,3051,825
08123,Weld County,Colorado,215564,12571,12570,53594,49835,20910,42730,23354,190423,66084
08125,Yuma County,Colorado,6666,586,425,1806,1573,647,1020,609,5655,1629
09110,Capitol Planning Region,Connecticut,675246,25897,34778,169941,111307,55774,154850,122699,614571,277549
09120,Greater Bridgeport Planning Region,Connecticut,221540,14311,11531,55769,33034,14460,52095,40340,195698,92435
09130,Lower Connecticut River Valley Planning Region,Connecticut,128960,2319,3775,30676,22256,11558,32151,26225,122866,58376
09140,Naugatuck Valley Planning Region,Connecticut,320582,14150,16781,96422,59424,27148,60414,46243,289651,106657
09150,Northeastern Connecticut Planning Region,Connecticut,68920,1922,4085,24018,14498,7145,9844,7408,62913,17252
09160,Northwest Hills Planning Region,Connecticut,82679,2460,3173,23638,14825,7222,18125,13236,77046,31361
09170,South Central Connecticut Planning Region,Connecticut,395812,15353,18584,112403,62392,27180,81523,78377,361875,159900
09180,Southeastern Connecticut Planning Region,Connecticut,197755,5537,9511,58571,40400,16870,38034,28832,182707,66866
09190,Western Connecticut Planning Region,Connecticut,429296,19871,16038,79350,56397,24810,126881,105949,393387,232830
10001,Kent County,Delaware,122811,4687,8967,40702,25750,10428,19471,12806,109157,32277
10003,New Castle County,Delaware,395423,11319,18351,112020,71351,31037,86580,64765,365753,151345
10005,Sussex County,Delaware,182130,5956,12064,55407,33893,17075,33162,24573,164110,57735
11001,District of Columbia,District of Columbia,484596,14584,20793,72816,58037,14834,124860,178672,449219,303532
12001,Alachua County,Florida,169342,3323,7453,33952,26583,18975,40168,38888,158566,79056
12003,Baker County,Florida,18827,673,2139,7978,3836,1541,1603,1057,16015,2660
12005,Bay County,Florida,129413,4142,8327,36364,30933,15181,22211,12255,116944,34466
12007,Bradford County,Florida,20149,1152,2448,7851,4513,1532,1602,1051,16549,2653
12009,Brevard County,Florida,455626,10295,23039,119111,98273,55035,91368,58505,422292,149873
12011,Broward County,Florida,1382985,59339,78974,370311,254697,136421,299209,184034,1244672,483243
12013,Calhoun County,Florida,10046,697,1382,4219,2087,549,769,343,7967,1112
12015,Charlotte County,Florida,157728,3663,9049,53154,37145,15077,24826,14814,145016,39640
12017,Citrus County,Florida,123782,3396,8447,46644,28708,12220,15052,9315,111939,24367
12019,Clay County,Florida,151800,3716,7632,42368,38047,18167,28107,13763,140452,41870
12021,Collier County,Florida,291752,17023,13489,75604,48149,24477,66537,46473,261240,113010
12023,Columbia County,Florida,48482,1760,5135,17479,11697,4634,5293,2484,41587,7777
12027,DeSoto County,Florida,25022,3171,3549,9956,3785,1661,1960,940,18302,2900
12029,Dixie County,Florida,12519,621,1787,6044,2175,893,661,338,10111,999
12031,Duval County,Florida,683191,21420,41962,190902,142577,66057,146544,73729,619809,220273
12033,Escambia County,Florida,218227,5415,14737,60117,51695,25006,38493,22764,198075,61257
12035,Flagler County,Florida,90826,2669,4368,28114,20614,9293,16803,8965,83789,25768
12037,Franklin County,Florida,9704,588,1317,3126,1904,736,1120,913,7799,2033
12039,Gadsden County,Florida,30567,1989,4031,10750,5717,2068,3856,2156,24547,6012
12041,Gilchrist County,Florida,12895,573,1234,5039,2809,1353,1284,603,11088,1887
12043,Glades County,Florida,9569,1108,1465,3306,1981,467,912,330,6996,1242
12045,Gulf County,Florida,11873,472,1223,4049,2498,1090,1515,1026,10178,2541
12047,Hamilton County,Florida,9968,656,1629,4400,1650,712,667,254,7683,921
12049,Hardee County,Florida,16581,2030,1628,7800,2342,1063,1169,549,12923,1718
12051,Hendry County,Florida,25602,4270,3536,9330,3574,2208,1947,737,17796,2684
12053,Hernando County,Florida,147268,4484,11187,48035,37501,16603,19903,9555,131597,29458
12055,Highlands County,Florida,79094,4227,6678,28096,18390,7242,9422,5039,68189,14461
12057,Hillsborough County,Florida,1009935,46521,61477,262086,176410,97389,231039,135013,901937,366052
12059,Holmes County,Florida,14115,637,1804,6452,2930,738,1089,465,11674,1554
12061,Indian River County,Florida,125938,3737,7048,33615,26750,13574,25090,16124,115153,41214
12063,Jackson County,Florida,34854,1621,3875,13833,7601,3087,2905,1932,29358,4837
12065,Jefferson County,Florida,10826,530,1078,4032,2244,827,1428,687,9218,2115
12067,Lafayette County,Florida,5864,527,733,2959,845,326,332,142,4604,474
12069,Lake County,Florida,287099,8020,19414,87800,64647,33498,46866,26854,259665,73720
12071,Lee County,Florida,583335,24153,33553,176083,118194,55635,108170,67547,525629,175717
12073,Leon County,Florida,175063,3556,8199,33556,30479,16088,46636,36549,163308,83185
12075,Levy County,Florida,31811,1438,2493,13294,5688,3776,3561,1561,27880,5122
12077,Liberty County,Florida,5516,267,779,2296,950,295,518,411,4470,929
12079,Madison County,Florida,13709,778,1940,4898,2936,1381,1204,572,10991,1776
12081,Manatee County,Florida,306549,10835,17667,89797,59492,28112,61199,39447,278047,100646
12083,Marion County,Florida,281911,9828,20498,99013,61218,29365,39294,22695,251585,61989
12085,Martin County,Florida,123856,3720,5684,30742,28681,11559,27796,15674,114452,43470
12086,Miami-Dade County,Florida,1918837,161141,171425,508164,269609,184168,388029,236301,1586271,624330
12087,Monroe County,Florida,64245,2273,2720,18156,12361,5393,14115,9227,59252,23342
12089,Nassau County,Florida,67839,1436,4104,19853,14180,6555,13840,7871,62299,21711
12091,Okaloosa County,Florida,146005,4001,6187,35919,34029,17287,30071,18511,135817,48582
12093,Okeechobee County,Florida,28352,2065,3634,10101,5799,1980,3190,1583,22653,4773
12095,Orange County,Florida,966029,42255,59742,231925,165103,106183,231437,129384,864032,360821
12097,Osceola County,Florida,261881,14352,17865,77576,53899,28749,47040,22400,229664,69440
12099,Palm Beach County,Florida,1099423,61975,59192,253992,196507,101639,258721,167397,978256,426118
12101,Pasco County,Florida,411953,11997,26285,136523,84401,41052,72486,39209,373671,111695
12103,Pinellas County,Florida,745450,19140,36728,198362,155547,74218,167442,94013,689582,261455
12105,Polk County,Florida,509692,27325,39385,172834,110582,50281,73601,35684,442982,109285
12107,Putnam County,Florida,52656,2563,6679,21978,10328,4092,4890,2126,43414,7016
12109,St. Johns County,Florida,198819,3562,6364,41492,35163,18082,58157,35999,188893,94156
12111,St. Lucie County,Florida,244780,10580,17372,75400,53379,26801,40046,21202,216828,61248
12113,Santa Rosa County,Florida,133200,2339,7484,36374,30429,16746,25825,14003,123377,39828
12115,Sarasota County,Florida,352738,6644,14138,93173,70383,33345,77261,57794,331956,135055
12117,Seminole County,Florida,334044,7321,13196,71190,63900,39051,90716,48670,313527,139386
12119,Sumter County,Florida,118708,1920,6954,34638,23685,11518,23971,16022,109834,39993
12121,Suwannee County,Florida,31122,2038,2845,12600,6600,2097,2831,2111,26239,4942
12123,Taylor County,Florida,15853,547,2106,6990,2942,1061,1541,666,13200,2207
12125,Union County,Florida,11097,490,1959,4354,2127,1054,679,434,8648,1113
12127,Volusia County,Florida,414960,11576,23370,128118,92044,51324,71226,37302,380014,108528
12129,Wakulla County,Florida,24288,776,2036,8907,5948,1825,2917,1879,21476,4796
12131,Walton County,Florida,56427,1434,3138,15856,11793,5502,12778,5926,51855,18704
12133,Washington County,Florida,18230,879,2208,7769,3997,1116,1302,959,15143,2261
13001,Appling County,Georgia,12283,989,1660,4675,2630,1098,676,555,9634,1231
13003,Atkinson County,Georgia,5468,931,686,1899,946,385,306,315,3851,621
13005,Bacon County,Georgia,7324,436,687,2800,1949,653,373,426,6201,799
13007,Baker County,Georgia,2055,86,208,737,345,289,227,163,1761,390
13009,Baldwin County,Georgia,27849,1089,2957,8876,6012,2384,3770,2761,23803,6531
13011,Banks County,Georgia,12937,829,1836,4434,2495,1128,1372,843,10272,2215
13013,Barrow County,Georgia,55726,2777,4131,18698,13334,4986,7743,4057,48818,11800
13015,Bartow County,Georgia,73182,3036,5838,27244,15948,5724,10517,4875,64308,15392
13017,Ben Hill County,Georgia,11502,596,1274,5905,1485,839,1003,400,9632,1403
13019,Berrien County,Georgia,12433,779,1546,4771,2212,1281,1211,633,10108,1844
13021,Bibb County,Georgia,103131,3803,10075,31676,22824,8086,13738,12929,89253,26667
13023,Bleckley County,Georgia,8151,382,602,2602,2202,850,897,616,7167,1513
13025,Brantley County,Georgia,12582,711,1858,5452,2193,1069,589,710,10013,1299
13027,Brooks County,Georgia,11428,739,1258,4246,2565,943,1114,563,9431,1677
13029,Bryan County,Georgia,28192,638,1513,7057,6574,2852,5989,3569,26041,9558
13031,Bulloch County,Georgia,45038,1057,4030,12931,9734,3942,8064,5280,39951,13344
13033,Burke County,Georgia,15584,931,1458,5889,3310,1712,1667,617,13195,2284
13035,Butts County,Georgia,17892,681,2231,7645,3961,1037,1494,843,14980,2337
13037,Calhoun County,Georgia,4212,321,682,1670,904,156,295,184,3209,479
13039,Camden County,Georgia,35521,526,2123,11519,10135,3524,4874,2820,32872,7694
13043,Candler County,Georgia,7318,785,861,2601,1737,439,590,305,5672,895
13045,Carroll County,Georgia,76484,3790,8042,26227,16347,5839,10252,5987,64652,16239
13047,Catoosa County,Georgia,47530,1508,3501,15360,11653,4464,6953,4091,42521,11044
13049,Charlton County,Georgia,9002,644,788,4070,1834,574,870,222,7570,1092
13051,Chatham County,Georgia,202409,5188,12170,50388,46649,15001,43032,29981,185051,73013
13053,Chattahoochee County,Georgia,4448,25,155,1041,1498,394,866,469,4268,1335
13055,Chattooga County,Georgia,17279,1702,2930,6632,3171,1207,950,687,12647,1637
13057,Cherokee County,Georgia,183322,6242,8104,41368,40548,14650,50928,21482,168976,72410
13059,Clarke County,Georgia,73265,2640,4784,13658,12273,4781,17848,17281,65841,35129
13061,Clay County,Georgia,1931,70,254,664,372,251,190,130,1607,320
13063,Clayton County,Georgia,185573,11249,15712,61521,41468,17380,25582,12661,158612,38243
13065,Clinch County,Georgia,4511,459,715,1659,810,287,412,169,3337,581
13067,Cobb County,Georgia,519750,19422,16795,92423,94395,38418,163719,94578,483533,258297
13069,Coffee County,Georgia,28579,2298,3909,11269,5130,2290,2268,1415,22372,3683
13071,Colquitt County,Georgia,29871,2482,4181,11053,5291,2470,2315,2079,23208,4394
13073,Columbia County,Georgia,104791,1838,5287,24127,21423,12893,22587,16636,97666,39223
13075,Cook County,Georgia,11189,674,1346,3850,2372,1156,1087,704,9169,1791
13077,Coweta County,Georgia,100309,2483,6772,26100,21379,9323,21935,12317,91054,34252
13079,Crawford County,Georgia,8525,443,1177,3533,1650,761,503,458,6905,961
13081,Crisp County,Georgia,13661,626,1810,5331,2842,1127,1157,768,11225,1925
13083,Dade County,Georgia,11294,455,1076,4140,2353,1202,1474,594,9763,2068
13085,Dawson County,Georgia,19579,670,1680,4281,4535,1470,4797,2146,17229,6943
13087,Decatur County,Georgia,19270,1390,2018,6676,4128,2170,1893,995,15862,2888
13089,DeKalb County,Georgia,522568,21369,25050,105920,86349,40059,137065,106756,476149,243821
13091,Dodge County,Georgia,14411,509,1423,6012,3405,937,1400,725,12479,2125
13093,Dooly County,Georgia,8557,429,1041,3645,1505,821,763,353,7087,1116
13095,Dougherty County,Georgia,55209,2419,6473,16317,11963,5178,7102,5757,46317,12859
13097,Douglas County,Georgia,93905,2974,6126,28310,20353,8101,17347,10694,84805,28041
13099,Early County,Georgia,6854,382,1004,2796,1147,566,621,338,5468,959
13101,Echols County,Georgia,2271,97,303,1053,383,118,195,122,1871,317
13103,Effingham County,Georgia,42691,942,3267,14343,9337,4049,7658,3095,38482,10753
13105,Elbert County,Georgia,13921,689,1858,5642,3007,767,1180,778,11374,1958
13107,Emanuel County,Georgia,15273,1033,2154,6248,2691,1374,1174,599,12086,1773
13109,Evans County,Georgia,6975,479,984,2665,1368,338,731,410,5512,1141
13111,Fannin County,Georgia,19858,886,1534,6827,4121,1882,2598,2010,17438,4608
13113,Fayette County,Georgia,81529,1491,2335,16863,15057,7264,23851,14668,77703,38519
13115,Floyd County,Georgia,65521,4060,6323,21379,14037,5104,8512,6106,55138,14618
13117,Forsyth County,Georgia,165931,4616,5489,24286,27078,11217,58027,35218,155826,93245
13119,Franklin County,Georgia,15957,897,2154,5310,3214,1694,1587,1101,12906,2688
13121,Fulton County,Georgia,730654,16738,30007,117584,104680,44777,242267,174601,683909,416868
13123,Gilmer County,Georgia,23455,1543,1747,8181,4282,2210,3307,2185,20165,5492
13125,Glascock County,Georgia,1987,156,198,782,389,205,232,25,1633,257
13127,Glynn County,Georgia,60152,2259,4869,16113,12844,5648,10955,7464,53024,18419
13129,Gordon County,Georgia,39102,3391,5267,13675,7740,2506,3675,2848,30444,6523
13131,Grady County,Georgia,17685,1297,2075,6395,3756,1365,1671,1126,14313,2797
13133,Greene County,Georgia,14155,521,1169,4298,2468,968,3029,1702,12465,4731
13135,Gwinnett County,Georgia,613696,37881,34585,138067,106453,57921,154792,83997,541230,238789
13137,Habersham County,Georgia,31309,2886,3153,10544,5622,1921,4024,3159,25270,7183
13139,Hall County,Georgia,135246,14680,10948,38366,27000,9771,21466,13015,109618,34481
13141,Hancock County,Georgia,6597,819,824,2371,1284,664,538,97,4954,635
13143,Haralson County,Georgia,20766,965,2337,8098,4405,1251,2281,1429,17464,3710
13145,Harris County,Georgia,24553,460,1153,6530,6029,2421,4385,3575,22940,7960
13147,Hart County,Georgia,19076,1003,2267,6579,3879,1865,2482,1001,15806,3483
13149,Heard County,Georgia,7848,356,894,3328,1934,425,602,309,6598,911
13151,Henry County,Georgia,156722,3933,7870,49963,34824,17048,28106,14978,144919,43084
13153,Houston County,Georgia,107796,2633,4934,29352,23692,12686,19718,14781,100229,34499
13155,Irwin County,Georgia,6529,315,877,2373,1414,452,551,547,5337,1098
13157,Jackson County,Georgia,52021,2327,4019,16821,10384,4672,9536,4262,45675,13798
13159,Jasper County,Georgia,10251,286,778,4524,2205,582,1036,840,9187,1876
13161,Jeff Davis County,Georgia,9717,463,1424,3710,2211,791,814,304,7830,1118
13163,Jefferson County,Georgia,10550,873,1191,4373,2337,635,794,347,8486,1141
13165,Jenkins County,Georgia,6607,373,846,2936,1512,342,326,272,5388,598
13167,Johnson County,Georgia,6644,338,1240,2910,982,543,276,355,5066,631
13169,Jones County,Georgia,19675,491,1158,8151,4091,2265,2276,1243,18026,3519
13171,Lamar County,Georgia,12272,358,938,4403,3345,1082,1122,1024,10976,2146
13173,Lanier County,Georgia,6569,338,528,2694,1235,564,744,466,5703,1210
13175,Laurens County,Georgia,33167,1075,3405,13833,6496,2694,2907,2757,28687,5664
13177,Lee County,Georgia,21270,515,1198,5776,4175,2664,4222,2720,19557,6942
13179,Liberty County,Georgia,37758,821,2125,12070,10620,4487,5266,2369,34812,7635
13181,Lincoln County,Georgia,5695,160,567,2374,1140,529,584,341,4968,925
13183,Long County,Georgia,10800,275,1472,4487,2226,940,848,552,9053,1400
13185,Lowndes County,Georgia,70095,2271,4990,22374,15201,6974,11039,7246,62834,18285
13187,Lumpkin County,Georgia,20748,483,2098,6087,4136,1299,3938,2707,18167,6645
13189,McDuffie County,Georgia,14705,453,1674,5895,2831,1149,1489,1214,12578,2703
13191,McIntosh County,Georgia,8928,270,1289,3272,1926,581,1052,538,7369,1590
13193,Macon County,Georgia,8627,787,1576,3375,1622,399,515,353,6264,868
13195,Madison County,Georgia,20802,1453,2060,7106,4284,1824,2002,2073,17289,4075
13197,Marion County,Georgia,5391,397,902,1976,1083,376,509,148,4092,657
13199,Meriwether County,Georgia,14753,624,1895,6266,3229,803,1186,750,12234,1936
13201,Miller County,Georgia,4072,248,457,1218,781,567,461,340,3367,801
13205,Mitchell County,Georgia,14690,774,1657,5323,3734,1397,933,872,12259,1805
13207,Monroe County,Georgia,19809,675,1617,6905,3387,1568,3120,2537,17517,5657
13209,Montgomery County,Georgia,5719,290,631,2202,938,538,606,514,4798,1120
13211,Morgan County,Georgia,14369,572,955,5094,2472,983,2519,1774,12842,4293
13213,Murray County,Georgia,27036,2787,3661,9573,5905,2041,2039,1030,20588,3069
13215,Muscogee County,Georgia,134389,4906,10483,36439,31445,12922,22117,16077,119000,38194
13217,Newton County,Georgia,73089,2470,5083,24171,18161,6702,9900,6602,65536,16502
13219,Oconee County,Georgia,27475,395,846,4420,5363,1763,7238,7450,26234,14688
13221,Oglethorpe County,Georgia,10536,444,879,4099,1828,898,1411,977,9213,2388
13223,Paulding County,Georgia,111586,2442,7591,33550,28598,9785,19595,10025,101553,29620
13225,Peach County,Georgia,18005,1016,1505,5800,3449,2112,2061,2062,15484,4123
13227,Pickens County,Georgia,24627,626,1823,8772,5361,2065,3942,2038,22178,5980
13229,Pierce County,Georgia,13247,779,983,5556,2337,1340,1244,1008,11485,2252
13231,Pike County,Georgia,13056,317,1241,4864,2745,1258,1489,1142,11498,2631
13233,Polk County,Georgia,28540,1862,3021,12165,5346,2049,2561,1536,23657,4097
13235,Pulaski County,Georgia,7360,963,453,2646,1812,538,603,345,5944,948
13237,Putnam County,Georgia,16260,795,1217,5545,3150,1391,2654,1508,14248,4162
13239,Quitman County,Georgia,1690,107,246,628,408,116,118,67,1337,185
13241,Rabun County,Georgia,13158,484,938,3935,3231,880,2052,1638,11736,3690
13243,Randolph County,Georgia,4233,304,494,1473,898,538,404,122,3435,526
13245,Richmond County,Georgia,135577,4315,12526,43659,30170,12971,19289,12647,118736,31936
13247,Rockdale County,Georgia,62583,2377,4166,17761,15117,5560,10631,6971,56040,17602
13249,Schley County,Georgia,3019,106,344,1046,693,288,302,240,2569,542
13251,Screven County,Georgia,10250,249,1296,3888,2193,1012,844,768,8705,1612
13253,Seminole County,Georgia,6698,197,611,2702,1362,687,741,398,5890,1139
13255,Spalding County,Georgia,46186,1667,5892,18094,7946,4127,5262,3198,38627,8460
13257,Stephens County,Georgia,18319,1003,1991,7465,3918,1012,1777,1153,15325,2930
13259,Stewart County,Georgia,4182,363,784,1507,702,165,467,194,3035,661
13261,Sumter County,Georgia,18489,1242,1765,6631,3551,1200,2616,1484,15482,4100
13263,Talbot County,Georgia,4411,187,544,1830,775,396,435,244,3680,679
13265,Taliaferro County,Georgia,1300,110,94,547,340,60,86,63,1096,149
13267,Tattnall County,Georgia,16973,1499,2187,6732,2979,1204,1288,1084,13287,2372
13269,Taylor County,Georgia,5518,435,1000,2141,713,328,566,335,4083,901
13271,Telfair County,Georgia,8699,933,1202,4142,1122,600,321,379,6564,700
13273,Terrell County,Georgia,6081,407,696,2280,1559,350,396,393,4978,789
13275,Thomas County,Georgia,31127,1195,3062,9786,6034,3635,4882,2533,26870,7415
13277,Tift County,Georgia,26945,1446,2887,8972,4928,3669,2594,2449,22612,5043
13279,Toombs County,Georgia,17297,1259,1688,6320,3845,1354,1511,1320,14350,2831
13281,Towns County,Georgia,9554,182,560,2655,2157,944,1754,1302,8812,3056
13283,Treutlen County,Georgia,4336,269,877,1914,414,268,480,114,3190,594
13285,Troup County,Georgia,46260,1596,3839,16972,10009,4449,5486,3909,40825,9395
13287,Turner County,Georgia,6043,532,704,2104,1248,820,453,182,4807,635
13289,Twiggs County,Georgia,6030,260,988,2560,1173,407,392,250,4782,642
13291,Union County,Georgia,19586,699,1619,6373,4004,1899,3047,1945,17268,4992
13293,Upson County,Georgia,19052,899,2070,7204,4060,1890,1873,1056,16083,2929
13295,Walker County,Georgia,47811,2565,4590,16960,10516,3776,5968,3436,40656,9404
13297,Walton County,Georgia,65681,2251,6250,21064,14724,5446,9940,6006,57180,15946
13299,Ware County,Georgia,24173,1428,3022,9638,4669,1757,2561,1098,19723,3659
13301,Warren County,Georgia,3692,381,650,1372,609,272,260,148,2661,408
13303,Washington County,Georgia,14066,800,1423,6176,2203,1013,1756,695,11843,2451
13305,Wayne County,Georgia,20263,995,1950,9049,3658,1749,1713,1149,17318,2862
13307,Webster County,Georgia,1709,184,138,579,462,187,129,30,1387,159
13309,Wheeler County,Georgia,4792,166,961,2126,703,225,557,54,3665,611
13311,White County,Georgia,19922,979,1885,6223,4723,1505,2647,1960,17058,4607
13313,Whitfield County,Georgia,66792,8897,8284,21079,12381,3743,7260,5148,49611,12408
13315,Wilcox County,Georgia,6487,272,997,2585,1296,453,455,429,5218,884
13317,Wilkes County,Georgia,7015,367,852,3130,1168,401,839,258,5796,1097
13319,Wilkinson County,Georgia,6122,240,410,2938,1181,615,494,244,5472,738
13321,Worth County,Georgia,14450,554,1548,6388,3088,1498,950,424,12348,1374
15001,Hawaii County,Hawaii,145052,3399,6898,42310,31263,16704,27870,16608,134755,44478
15003,Honolulu County,Hawaii,706586,25359,26173,179627,137908,78639,164506,94374,655054,258880
15005,Kalawao County,Hawaii,50,2,2,17,10,2,10,7,46,17
15007,Kauai County,Hawaii,52686,2052,1898,15223,11161,6351,11228,4773,48736,16001
15009,Maui County,Hawaii,118155,4013,4797,35650,26724,11364,23629,11978,109345,35607
16001,Ada County,Idaho,340007,5303,10669,67466,80571,30610,94823,50565,324035,145388
16003,Adams County,Idaho,3489,69,139,1252,953,333,436,307,3281,743
16005,Bannock County,Idaho,55903,838,2863,14236,15520,5949,10949,5548,52202,16497
16007,Bear Lake County,Idaho,4244,39,254,1495,1121,453,604,278,3951,882
16009,Benewah County,Idaho,6892,171,853,2365,1521,700,883,399,5868,1282
16011,Bingham County,Idaho,29380,1485,1918,9498,7492,3155,4176,1656,25977,5832
16013,Blaine County,Idaho,17446,574,853,4303,3068,880,5439,2329,16019,7768
16015,Boise County,Idaho,6136,53,227,1779,1497,918,1079,583,5856,1662
16017,Bonner County,Idaho,35969,811,2323,10858,9110,3096,6500,3271,32835,9771
16019,Bonneville County,Idaho,75960,2259,3842,19117,18430,8097,16371,7844,69859,24215
16021,Boundary County,Idaho,8561,395,729,3167,2086,630,952,602,7437,1554
16023,Butte County,Idaho,1873,61,119,554,452,383,232,72,1693,304
16025,Camas County,Idaho,733,81,13,217,163,61,136,62,639,198
16027,Canyon County,Idaho,147654,8169,11061,44195,38653,13688,22406,9482,128424,31888
16029,Caribou County,Idaho,4501,163,268,1542,1329,494,454,251,4070,705
16031,Cassia County,Idaho,14855,986,1139,4299,3958,1429,2163,881,12730,3044
16033,Clark County,Idaho,498,76,115,141,75,15,54,22,307,76
16035,Clearwater County,Idaho,7082,108,476,2620,2029,567,872,410,6498,1282
16037,Custer County,Idaho,3457,83,218,929,898,334,814,181,3156,995
16039,Elmore County,Idaho,18203,1049,1133,5256,4723,2246,2806,990,16021,3796
16041,Franklin County,Idaho,8542,55,620,3933,1965,499,1007,463,7867,1470
16043,Fremont County,Idaho,9060,328,593,2729,2354,1119,1526,411,8139,1937
16045,Gem County,Idaho,13550,385,948,4714,3566,895,2476,566,12217,3042
16047,Gooding County,Idaho,10051,716,1395,3402,2254,696,1123,465,7940,1588
16049,Idaho County,Idaho,12470,172,795,4339,3100,1388,2059,617,11503,2676
16051,Jefferson County,Idaho,18071,545,799,4610,4494,2785,3264,1574,16727,4838
16053,Jerome County,Idaho,15020,2002,1709,4288,3376,1677,1311,657,11309,1968
16055,Kootenai County,Idaho,121326,2149,5673,32920,34583,13574,21597,10830,113504,32427
16057,Latah County,Idaho,23242,219,498,4890,5331,2003,6316,3985,22525,10301
16059,Lemhi County,Idaho,6015,91,409,1887,1573,721,811,523,5515,1334
16061,Lewis County,Idaho,2619,74,190,795,784,291,329,156,2355,485
16063,Lincoln County,Idaho,3410,354,275,1179,795,425,217,165,2781,382
16065,Madison County,Idaho,17543,73,382,2934,4931,2372,4845,2006,17088,6851
16067,Minidoka County,Idaho,13452,1371,1141,4874,2748,1177,1213,928,10940,2141
16069,Nez Perce County,Idaho,29485,736,1336,8764,7750,3331,5147,2421,27413,7568
16071,Oneida County,Idaho,2926,12,181,1133,686,218,525,171,2733,696
16073,Owyhee County,Idaho,8004,1147,768,2742,1785,448,847,267,6089,1114
16075,Payette County,Idaho,17063,937,1468,5869,3878,1472,2481,958,14658,3439
16077,Power County,Idaho,4837,403,357,1551,1489,327,473,237,4077,710
16079,Shoshone County,Idaho,9706,261,898,3575,2786,1056,675,455,8547,1130
16081,Teton County,Idaho,8147,311,226,1475,1566,733,2754,1082,7610,3836
16083,Twin Falls County,Idaho,58172,3191,4141,16487,14059,6569,8180,5545,50840,13725
16085,Valley County,Idaho,9282,172,499,2497,1855,880,2184,1195,8611,3379
16087,Washington County,Idaho,7460,407,323,2302,2207,917,863,441,6730,1304
17001,Adams County,Illinois,45657,706,2332,15765,10095,4466,8164,4129,42619,12293
17003,Alexander County,Illinois,3759,179,333,1572,1003,283,222,167,3247,389
17005,Bond County,Illinois,11499,266,1008,3732,2953,1118,1404,1018,10225,2422
17007,Boone County,Illinois,35284,2454,2267,11396,7905,2792,5325,3145,30563,8470
17009,Brown County,Illinois,4604,170,737,1841,850,360,496,150,3697,646
17011,Bureau County,Illinois,23667,712,1583,8250,5723,2321,3356,1722,21372,5078
17013,Calhoun County,Illinois,3272,55,206,1186,583,603,452,187,3011,639
17015,Carroll County,Illinois,11436,435,894,4102,2861,1008,1553,583,10107,2136
17017,Cass County,Illinois,8733,577,631,3719,1484,642,1249,431,7525,1680
17019,Champaign County,Illinois,120366,1993,4421,26456,22032,10549,24912,30003,113952,54915
17021,Christian County,Illinois,24101,507,1798,10596,4723,2335,2981,1161,21796,4142
17023,Clark County,Illinois,10749,243,593,3797,1902,1589,1790,835,9913,2625
17025,Clay County,Illinois,9254,412,687,3475,1924,1367,890,499,8155,1389
17027,Clinton County,Illinois,26316,797,1308,8690,5088,4221,4352,1860,24211,6212
17029,Coles County,Illinois,30496,643,1812,9707,6757,3350,4881,3346,28041,8227
17031,Cook County,Illinois,3639978,223360,205853,813182,648334,246535,874091,628623,3210765,1502714
17033,Crawford County,Illinois,13584,409,1133,3886,2919,2667,1669,901,12042,2570
17035,Cumberland County,Illinois,7407,174,314,2889,1496,1220,884,430,6919,1314
17037,DeKalb County,Illinois,59829,1865,2302,14908,14173,6200,12450,7931,55662,20381
17039,De Witt County,Illinois,11080,172,474,4579,2610,864,1586,795,10434,2381
17041,Douglas County,Illinois,13255,1367,653,4494,2674,1433,1847,787,11235,2634
17043,DuPage County,Illinois,642881,21564,20280,116010,108439,48302,195110,133176,601037,328286
17045,Edgar County,Illinois,12383,421,1072,4820,2559,1184,1661,666,10890,2327
17047,Edwards County,Illinois,4338,95,292,1496,1065,787,436,167,3951,603
17049,Effingham County,Illinois,23734,594,946,7705,5082,3249,4213,1945,22194,6158
17051,Fayette County,Illinois,15207,626,1411,6159,2948,1809,1629,625,13170,2254
17053,Ford County,Illinois,9337,210,562,3311,2488,920,1102,744,8565,1846
17055,Franklin County,Illinois,26692,591,2093,8796,7163,3336,3286,1427,24008,4713
17057,Fulton County,Illinois,24468,410,2054,9155,5548,2973,2980,1348,22004,4328
17059,Gallatin County,Illinois,3676,125,344,1407,951,393,276,180,3207,456
17061,Greene County,Illinois,8500,206,611,3879,1687,804,909,404,7683,1313
17063,Grundy County,Illinois,35053,718,1391,11203,9034,3703,5864,3140,32944,9004
17065,Hamilton County,Illinois,5698,339,440,1751,1448,742,565,413,4919,978
17067,Hancock County,Illinois,12666,170,535,4371,2878,1601,2154,957,11961,3111
17069,Hardin County,Illinois,2986,169,210,1137,696,415,201,158,2607,359
17071,Henderson County,Illinois,4772,56,278,1901,1078,471,743,245,4438,988
17073,Henry County,Illinois,34814,787,1840,11889,7586,4126,5767,2819,32187,8586
17075,Iroquois County,Illinois,19152,668,1491,7517,4093,2003,2502,878,16993,3380
17077,Jackson County,Illinois,32045,952,1662,7109,8155,2880,5608,5679,29431,11287
17079,Jasper County,Illinois,6488,100,334,2394,1102,1171,972,415,6054,1387
17081,Jefferson County,Illinois,25881,679,1750,8213,7073,3471,2993,1702,23452,4695
17083,Jersey County,Illinois,15046,327,674,5760,3033,1974,2037,1241,14045,3278
17085,Jo Daviess County,Illinois,16549,453,616,5726,3305,1839,3010,1600,15480,4610
17087,Johnson County,Illinois,9522,410,1053,3146,2320,1008,1116,469,8059,1585
17089,Kane County,Illinois,341945,24813,21344,77147,68345,26022,79861,44413,295788,124274
17091,Kankakee County,Illinois,71934,2657,4588,25346,17587,7139,8806,5811,64689,14617
17093,Kendall County,Illinois,84909,2005,3605,20833,18640,9454,19178,11194,79299,30372
17095,Knox County,Illinois,34854,1128,2788,11908,7581,4336,4754,2359,30938,7113
17097,Lake County,Illinois,470203,22672,20597,93285,82636,30259,128444,92310,426934,220754
17099,LaSalle County,Illinois,77499,1935,4976,27528,19619,9174,9511,4756,70588,14267
17101,Lawrence County,Illinois,11072,402,1242,3964,2420,1481,1011,552,9428,1563
17103,Lee County,Illinois,25055,586,1912,9008,6235,2580,3046,1688,22557,4734
17105,Livingston County,Illinois,25201,736,1654,10066,5900,2142,3100,1603,22811,4703
17107,Logan County,Illinois,19761,373,1303,7597,4776,1725,2695,1292,18085,3987
17109,McDonough County,Illinois,16716,301,632,5634,3210,1727,2678,2534,15783,5212
17111,McHenry County,Illinois,213347,5248,7782,56108,48590,20281,49733,25605,200317,75338
17113,McLean County,Illinois,105439,1363,2981,24329,19950,8332,32113,16371,101095,48484
17115,Macon County,Illinois,71303,1397,4039,26398,16332,6113,11357,5667,65867,17024
17117,Macoupin County,Illinois,32052,671,2222,12714,6895,3362,4294,1894,29159,6188
17119,Madison County,Illinois,184674,3273,9025,53081,44911,20171,34114,20099,172376,54213
17121,Marion County,Illinois,25988,703,1903,9478,6638,2924,2877,1465,23382,4342
17123,Marshall County,Illinois,8535,169,512,3309,2001,1056,1065,423,7854,1488
17125,Mason County,Illinois,9456,294,526,3668,2148,1182,1154,484,8636,1638
17127,Massac County,Illinois,10115,495,753,3639,2553,1185,1021,469,8867,1490
17129,Menard County,Illinois,8663,82,350,2900,2047,1043,1355,886,8231,2241
17131,Mercer County,Illinois,11231,230,620,4404,2737,1232,1285,723,10381,2008
17133,Monroe County,Illinois,24746,161,907,6115,5491,2702,5921,3449,23678,9370
17135,Montgomery County,Illinois,20588,525,1591,8805,4289,1633,2389,1356,18472,3745
17137,Morgan County,Illinois,23217,581,1826,9094,4789,1717,3509,1701,20810,5210
17139,Moultrie County,Illinois,9759,856,472,3177,2303,927,1365,659,8431,2024
17141,Ogle County,Illinois,35975,1175,1959,12094,8490,3838,5486,2933,32841,8419
17143,Peoria County,Illinois,121844,2709,5995,33563,26668,11841,24988,16080,113140,41068
17145,Perry County,Illinois,15183,540,1814,5336,4043,1788,1133,529,12829,1662
17147,Piatt County,Illinois,11840,154,574,3808,2335,1319,2318,1332,11112,3650
17149,Pike County,Illinois,10348,224,703,4301,2321,930,1357,512,9421,1869
17151,Pope County,Illinois,2901,153,190,1190,659,261,303,145,2558,448
17153,Pulaski County,Illinois,3627,111,321,1477,895,297,325,201,3195,526
17155,Putnam County,Illinois,4134,41,222,1524,875,501,620,351,3871,971
17157,Randolph County,Illinois,21938,832,2231,8358,5491,2012,1891,1123,18875,3014
17159,Richland County,Illinois,10930,240,627,3497,2510,1994,1370,692,10063,2062
17161,Rock Island County,Illinois,98788,3755,6528,29595,24739,10401,15122,8648,88505,23770
17163,St. Clair County,Illinois,175247,4173,9442,46507,42168,19719,31097,22141,161632,53238
17165,Saline County,Illinois,17219,808,1227,5129,4192,2382,2439,1042,15184,3481
17167,Sangamon County,Illinois,136783,2242,7059,38772,29463,11961,28222,19064,127482,47286
17169,Schuyler County,Illinois,5271,73,366,2067,1328,545,592,300,4832,892
17171,Scott County,Illinois,3462,68,183,1596,563,290,594,168,3211,762
17173,Shelby County,Illinois,15077,251,671,6406,3176,1817,1986,770,14155,2756
17175,Stark County,Illinois,3848,121,228,1539,765,465,524,206,3499,730
17177,Stephenson County,Illinois,31630,780,1809,10577,8651,3400,4130,2283,29041,6413
17179,Tazewell County,Illinois,92232,1784,4055,28343,21666,11016,17268,8100,86393,25368
17181,Union County,Illinois,12380,603,884,4274,2823,1106,1845,845,10893,2690
17183,Vermilion County,Illinois,50638,1273,3509,20992,10881,6074,4973,2936,45856,7909
17185,Wabash County,Illinois,8048,156,404,2579,1742,1680,934,553,7488,1487
17187,Warren County,Illinois,10936,520,847,3783,2345,1136,1545,760,9569,2305
17189,Washington County,Illinois,9907,298,442,3254,2083,1546,1495,789,9167,2284
17191,Wayne County,Illinois,11318,526,687,3858,2597,1861,1205,584,10105,1789
17193,White County,Illinois,9985,414,737,3376,2302,1559,997,600,8834,1597
17195,Whiteside County,Illinois,39020,1290,2311,14744,8843,4296,4612,2924,35419,7536
17197,Will County,Illinois,463903,18318,20654,119309,98136,40121,105392,61973,424931,167365
17199,Williamson County,Illinois,47967,1031,2450,13965,12059,5457,7790,5215,44486,13005
17201,Winnebago County,Illinois,193727,6945,15257,60308,46064,18387,29684,17082,171525,46766
17203,Woodford County,Illinois,25834,345,1147,7173,5027,2998,5778,3366,24342,9144
18001,Adams County,Indiana,21481,2041,816,9543,3622,2153,2340,966,18624,3306
18003,Allen County,Indiana,251806,11404,13496,70966,52726,26452,51044,25718,226906,76762
18005,Bartholomew County,Indiana,56069,1347,3238,17489,9751,4727,11174,8343,51484,19517
18007,Benton County,Indiana,5877,209,463,2388,1292,427,872,226,5205,1098
18009,Blackford County,Indiana,8474,204,610,4171,1534,703,779,473,7660,1252
18011,Boone County,Indiana,47456,853,1522,9173,8130,4288,14669,8821,45081,23490
18013,Brown County,Indiana,11918,180,668,4160,2398,1234,2015,1263,11070,3278
18015,Carroll County,Indiana,14274,350,1032,6174,2729,1613,1565,811,12892,2376
18017,Cass County,Indiana,26047,1616,2103,11013,4901,2401,2599,1414,22328,4013
18019,Clark County,Indiana,84734,2206,5823,28251,18512,9098,14075,6769,76705,20844
18021,Clay County,Indiana,18327,389,1178,7597,3493,2565,2202,903,16760,3105
18023,Clinton County,Indiana,21391,1036,1752,9474,3693,1944,2293,1199,18603,3492
18025,Crawford County,Indiana,7507,262,815,3572,1337,603,587,331,6430,918
18027,Daviess County,Indiana,20803,3004,1771,7271,3060,2548,2232,917,16028,3149
18029,Dearborn County,Indiana,35409,843,2301,13641,6433,3430,5821,2940,32265,8761
18031,Decatur County,Indiana,17908,558,1026,7671,3149,1841,2753,910,16324,3663
18033,DeKalb County,Indiana,29344,658,1879,12760,5686,2797,3936,1628,26807,5564
18035,Delaware County,Indiana,69984,1281,5250,23497,15266,6866,10495,7329,63453,17824
18037,Dubois County,Indiana,29469,1335,1646,11397,4388,3652,5105,1946,26488,7051
18039,Elkhart County,Indiana,131038,11028,12332,47311,24587,9526,17339,8915,107678,26254
18041,Fayette County,Indiana,16326,763,1651,7271,2888,1235,1863,655,13912,2518
18043,Floyd County,Indiana,55456,1218,3011,17266,11502,5104,10841,6514,51227,17355
18045,Fountain County,Indiana,11606,411,880,5290,2335,1124,1011,555,10315,1566
18047,Franklin County,Indiana,15813,516,1139,6345,3200,1342,2090,1181,14158,3271
18049,Fulton County,Indiana,13974,489,1283,5459,3134,1121,1707,781,12202,2488
18051,Gibson County,Indiana,22417,513,1591,9142,4399,2745,2907,1120,20313,4027
18053,Grant County,Indiana,44085,1531,3502,16838,9677,4412,4783,3342,39052,8125
18055,Greene County,Indiana,21948,602,1973,8713,4626,2495,2434,1105,19373,3539
18057,Hamilton County,Indiana,230317,2202,4340,34109,33258,16434,87064,52910,223775,139974
18059,Hancock County,Indiana,55513,872,2833,16687,11826,5073,12440,5782,51808,18222
18061,Harrison County,Indiana,28044,567,2176,11360,5754,2397,3825,1965,25301,5790
18063,Hendricks County,Indiana,118031,1624,6075,31408,23376,9245,30424,15879,110332,46303
18065,Henry County,Indiana,34936,855,2244,15099,7720,3057,4026,1935,31837,5961
18067,Howard County,Indiana,57679,1714,3308,21836,13875,5504,7700,3742,52657,11442
18069,Huntington County,Indiana,25375,418,1467,10841,4583,2503,3695,1868,23490,5563
18071,Jackson County,Indiana,31506,1145,1995,13232,6694,2592,3867,1981,28366,5848
18073,Jasper County,Indiana,22772,428,1187,9865,4982,1981,2873,1456,21157,4329
18075,Jay County,Indiana,13590,726,973,6298,2613,1221,1022,737,11891,1759
18077,Jefferson County,Indiana,23144,887,1924,9152,4309,2711,2572,1589,20333,4161
18079,Jennings County,Indiana,19022,464,1664,8330,4415,1459,1848,842,16894,2690
18081,Johnson County,Indiana,108217,2808,5248,33474,21872,9714,22035,13066,100161,35101
18083,Knox County,Indiana,24166,783,1860,8606,5012,3529,2815,1561,21523,4376
18085,Kosciusko County,Indiana,54022,2812,3768,19034,11220,4154,8312,4722,47442,13034
18087,LaGrange County,Indiana,23540,7484,1795,7088,3137,1393,1652,991,14261,2643
18089,Lake County,Indiana,338457,12984,20140,119701,73707,29168,54950,27807,305333,82757
18091,LaPorte County,Indiana,78906,2261,5723,30864,16382,7039,11189,5448,70922,16637
18093,Lawrence County,Indiana,31977,1001,2474,12332,6622,3473,3565,2510,28502,6075
18095,Madison County,Indiana,91235,2439,6764,35710,19587,9005,11740,5990,82032,17730
18097,Marion County,Indiana,638893,28970,51906,175730,120343,49738,136520,75686,558017,212206
18099,Marshall County,Indiana,30949,1753,2650,11702,6095,2549,4012,2188,26546,6200
18101,Martin County,Indiana,6871,209,561,2920,1234,980,651,316,6101,967
18103,Miami County,Indiana,25196,1126,2202,10701,4974,2281,2731,1181,21868,3912
18105,Monroe County,Indiana,82493,910,3496,17646,14427,6250,19900,19864,78087,39764
18107,Montgomery County,Indiana,25900,691,2119,10665,5191,1836,3398,2000,23090,5398
18109,Morgan County,Indiana,50065,995,4253,19419,10459,4783,6802,3354,44817,10156
18111,Newton County,Indiana,9886,450,835,4482,2070,723,990,336,8601,1326
18113,Noble County,Indiana,31895,2875,2491,12621,5641,2612,3931,1724,26529,5655
18115,Ohio County,Indiana,4392,58,263,1986,950,447,489,199,4071,688
18117,Orange County,Indiana,13737,722,1297,6143,2489,1170,1279,637,11718,1916
18119,Owen County,Indiana,15452,635,1473,6636,3020,1324,1649,715,13344,2364
18121,Parke County,Indiana,11469,864,823,4352,2437,1265,1027,701,9782,1728
18123,Perry County,Indiana,13667,276,927,6268,2689,1298,1541,668,12464,2209
18125,Pike County,Indiana,8607,273,551,4111,1704,753,799,416,7783,1215
18127,Porter County,Indiana,120140,2326,4954,41477,25051,10398,22294,13640,112860,35934
18129,Posey County,Indiana,17929,365,759,6514,3650,2073,3022,1546,16805,4568
18131,Pulaski County,Indiana,8696,264,772,3943,1852,643,769,453,7660,1222
18133,Putnam County,Indiana,24842,726,1542,9635,5835,2277,3194,1633,22574,4827
18135,Randolph County,Indiana,17048,450,1274,7215,4045,1485,1598,981,15324,2579
18137,Ripley County,Indiana,19738,573,1290,8384,3678,2063,2105,1645,17875,3750
18139,Rush County,Indiana,11642,371,861,5336,2276,975,1211,612,10410,1823
18141,St. Joseph County,Indiana,177621,4371,11849,53166,35682,15790,34030,22733,161401,56763
18143,Scott County,Indiana,16991,871,2202,7615,2887,1458,1324,634,13918,1958
18145,Shelby County,Indiana,31447,1054,2365,13225,5887,2745,4206,1965,28028,6171
18147,Spencer County,Indiana,14156,284,773,5703,2709,1868,1752,1067,13099,2819
18149,Starke County,Indiana,16188,919,1493,7025,3304,1324,1397,726,13776,2123
18151,Steuben County,Indiana,23736,447,1275,9300,4868,2048,3772,2026,22014,5798
18153,Sullivan County,Indiana,14972,485,1184,6301,2859,2071,1413,659,13303,2072
18155,Switzerland County,Indiana,6753,388,751,3082,1285,516,558,173,5614,731
18157,Tippecanoe County,Indiana,103685,3116,5156,28052,18313,8538,22967,17543,95413,40510
18159,Tipton County,Indiana,10978,290,725,4074,2075,1092,1887,835,9963,2722
18161,Union County,Indiana,5038,93,472,1837,1056,577,721,282,4473,1003
18163,Vanderburgh County,Indiana,123502,2858,7988,39963,25837,13440,22056,11360,112656,33416
18165,Vermillion County,Indiana,10900,168,649,4437,2270,1430,1378,568,10083,1946
18167,Vigo County,Indiana,68381,1607,4913,22731,15073,6547,10353,7157,61861,17510
18169,Wabash County,Indiana,21621,517,1332,9043,4073,1967,2930,1759,19772,4689
18171,Warren County,Indiana,6046,93,355,2500,1334,603,822,339,5598,1161
18173,Warrick County,Indiana,44259,638,1609,12514,8667,5567,9148,6116,42012,15264
18175,Washington County,Indiana,19598,950,1500,8202,4045,2131,2036,734,17148,2770
18177,Wayne County,Indiana,45558,1927,3520,16553,10243,4651,5351,3313,40111,8664
18179,Wells County,Indiana,18997,292,981,8107,3804,2182,2590,1041,17724,3631
18181,White County,Indiana,16992,484,1158,6785,3954,1504,2131,976,15350,3107
18183,Whitley County,Indiana,23775,623,1318,8848,4766,2808,3974,1438,21834,5412
19001,Adair County,Iowa,5285,80,147,2174,1152,727,755,250,5058,1005
19003,Adams County,Iowa,2644,75,83,937,535,447,442,125,2486,567
19005,Allamakee County,Iowa,9729,337,471,4033,1809,1284,1319,476,8921,1795
19007,Appanoose County,Iowa,8720,366,336,3277,1947,1156,1223,415,8018,1638
19009,Audubon County,Iowa,4054,122,262,1454,862,475,648,231,3670,879
19011,Benton County,Iowa,17867,279,717,6172,3801,2731,2879,1288,16871,4167
19013,Black Hawk County,Iowa,82951,2098,3791,25036,17356,9807,16143,8720,77062,24863
19015,Boone County,Iowa,19033,158,760,6149,4120,2824,3658,1364,18115,5022
19017,Bremer County,Iowa,16513,187,456,5068,2878,2308,3826,1790,15870,5616
19019,Buchanan County,Iowa,13831,386,496,4924,3179,1926,2062,858,12949,2920
19021,Buena Vista County,Iowa,13055,1481,1216,4098,2045,1391,1889,935,10358,2824
19023,Butler County,Iowa,10159,138,518,3764,2200,1572,1542,425,9503,1967
19025,Calhoun County,Iowa,7078,78,353,2593,1542,997,1074,441,6647,1515
19027,Carroll County,Iowa,14088,346,407,5068,3068,2082,2312,805,13335,3117
19029,Cass County,Iowa,9380,174,647,3503,2160,940,1426,530,8559,1956
19031,Cedar County,Iowa,13224,213,374,5301,2673,1900,2013,750,12637,2763
19033,Cerro Gordo County,Iowa,30790,653,1275,10584,6219,4681,5056,2322,28862,7378
19035,Cherokee County,Iowa,8270,177,387,3350,1552,1008,1186,610,7706,1796
19037,Chickasaw County,Iowa,8212,241,281,3711,1382,1068,1150,379,7690,1529
19039,Clarke County,Iowa,6309,230,749,2668,1143,557,611,351,5330,962
19041,Clay County,Iowa,11256,71,437,3611,2733,1475,2059,870,10748,2929
19043,Clayton County,Iowa,12308,416,726,5297,2422,1334,1573,540,11166,2113
19045,Clinton County,Iowa,32458,508,2080,12072,6861,3923,4879,2135,29870,7014
19047,Crawford County,Iowa,10648,1009,851,3713,2314,1045,1340,376,8788,1716
19049,Dallas County,Iowa,65734,1082,1369,12229,11128,6053,22847,11026,63283,33873
19051,Davis County,Iowa,5698,940,248,1678,1026,726,782,298,4510,1080
19053,Decatur County,Iowa,4761,211,309,1773,886,398,685,499,4241,1184
19055,Delaware County,Iowa,12042,278,671,5124,2076,1662,1638,593,11093,2231
19057,Des Moines County,Iowa,27152,431,1486,9477,5735,3685,4164,2174,25235,6338
19059,Dickinson County,Iowa,13171,209,247,3761,2851,1795,3246,1062,12715,4308
19061,Dubuque County,Iowa,66284,1289,2687,22138,11788,7151,14121,7110,62308,21231
19063,Emmet County,Iowa,6678,278,573,2229,1430,1153,735,280,5827,1015
19065,Fayette County,Iowa,13601,347,620,5730,2880,1689,1684,651,12634,2335
19067,Floyd County,Iowa,10875,392,349,4441,2175,1538,1421,559,10134,1980
19069,Franklin County,Iowa,6948,249,279,2703,1580,849,1053,235,6420,1288
19071,Fremont County,Iowa,4738,64,177,1701,1158,730,765,143,4497,908
19073,Greene County,Iowa,6218,117,308,2183,1455,930,893,332,5793,1225
19075,Grundy County,Iowa,8580,100,256,2869,1755,1357,1678,565,8224,2243
19077,Guthrie County,Iowa,7603,113,324,2597,1801,1122,1168,478,7166,1646
19079,Hamilton County,Iowa,10592,358,423,3639,2156,1631,1871,514,9811,2385
19081,Hancock County,Iowa,7683,111,555,2772,1593,1101,1262,289,7017,1551
19083,Hardin County,Iowa,12328,257,560,4308,2896,1741,1845,721,11511,2566
19085,Harrison County,Iowa,10166,183,521,3840,2497,1031,1529,565,9462,2094
19087,Henry County,Iowa,13931,463,771,4790,3068,1662,2215,962,12697,3177
19089,Howard County,Iowa,6381,293,215,2622,1196,830,983,242,5873,1225
19091,Humboldt County,Iowa,6652,90,299,2467,1307,1268,963,258,6263,1221
19093,Ida County,Iowa,4740,67,263,1868,927,681,726,208,4410,934
19095,Iowa County,Iowa,11550,234,496,4103,2501,1587,1876,753,10820,2629
19097,Jackson County,Iowa,13787,300,530,5795,3135,1490,1826,711,12957,2537
19099,Jasper County,Iowa,26686,552,998,10838,5568,3481,3679,1570,25136,5249
19101,Jefferson County,Iowa,12023,332,471,2866,2271,1335,2716,2032,11220,4748
19103,Johnson County,Iowa,90653,1732,1852,14104,15950,7947,26707,22361,87069,49068
19105,Jones County,Iowa,14978,221,638,5785,2845,2124,2322,1043,14119,3365
19107,Keokuk County,Iowa,6987,140,316,3087,1418,883,816,327,6531,1143
19109,Kossuth County,Iowa,10439,175,479,3609,2452,1646,1513,565,9785,2078
19111,Lee County,Iowa,23857,358,1053,9041,5143,3409,3476,1377,22446,4853
19113,Linn County,Iowa,155869,2132,5669,40914,32482,20754,36999,16919,148068,53918
19115,Louisa County,Iowa,7582,368,688,2964,1568,900,864,230,6526,1094
19117,Lucas County,Iowa,6066,216,247,2675,1427,598,651,252,5603,903
19119,Lyon County,Iowa,7724,228,180,3215,1397,1203,1174,327,7316,1501
19121,Madison County,Iowa,11322,116,224,3855,2901,1304,2186,736,10982,2922
19123,Mahaska County,Iowa,14716,351,650,5630,3052,1739,2462,832,13715,3294
19125,Marion County,Iowa,22248,434,879,7140,4273,2464,4750,2308,20935,7058
19127,Marshall County,Iowa,26441,2412,1503,8857,5145,2969,3938,1617,22526,5555
19129,Mills County,Iowa,10081,122,377,2921,2355,1229,2116,961,9582,3077
19131,Mitchell County,Iowa,7240,257,304,2575,1383,1169,1140,412,6679,1552
19133,Monona County,Iowa,6202,114,318,2465,1651,681,696,277,5770,973
19135,Monroe County,Iowa,5203,133,229,2066,980,616,962,217,4841,1179
19137,Montgomery County,Iowa,7219,159,445,2502,1693,1077,975,368,6615,1343
19139,Muscatine County,Iowa,28939,1037,1825,10143,5804,3411,4732,1987,26077,6719
19141,O'Brien County,Iowa,9734,215,687,3615,1718,1399,1658,442,8832,2100
19143,Osceola County,Iowa,4374,288,317,1666,874,609,431,189,3769,620
19145,Page County,Iowa,11345,223,588,4627,2514,1387,1381,625,10534,2006
19147,Palo Alto County,Iowa,6058,136,291,1827,1731,851,883,339,5631,1222
19149,Plymouth County,Iowa,17302,488,495,6231,3432,2491,3099,1066,16319,4165
19151,Pocahontas County,Iowa,4946,67,352,1867,1095,721,644,200,4527,844
19153,Polk County,Iowa,328511,11668,12349,81094,61856,33699,87045,40800,304494,127845
19155,Pottawattamie County,Iowa,63639,1817,4145,21412,14160,7197,10266,4642,57677,14908
19157,Poweshiek County,Iowa,12160,286,336,4745,2140,1141,1983,1529,11538,3512
19159,Ringgold County,Iowa,3213,61,132,1206,719,369,508,218,3020,726
19161,Sac County,Iowa,6902,186,252,2375,1618,977,1109,385,6464,1494
19163,Scott County,Iowa,118337,2309,4797,31530,24920,13454,26358,14969,111231,41327
19165,Shelby County,Iowa,8325,143,336,2889,1835,1224,1360,538,7846,1898
19167,Sioux County,Iowa,21356,951,838,6154,3758,2978,4767,1910,19567,6677
19169,Story County,Iowa,51740,416,1110,8372,8976,5684,15589,11593,50214,27182
19171,Tama County,Iowa,11597,407,638,4819,2185,1423,1490,635,10552,2125
19173,Taylor County,Iowa,4110,156,214,1698,906,501,483,152,3740,635
19175,Union County,Iowa,8235,122,472,2845,2058,755,1424,559,7641,1983
19177,Van Buren County,Iowa,5072,430,159,1963,1074,510,638,298,4483,936
19179,Wapello County,Iowa,24087,1147,1761,9149,4687,2896,2795,1652,21179,4447
19181,Warren County,Iowa,34895,327,911,10471,7372,4595,7787,3432,33657,11219
19183,Washington County,Iowa,15309,520,656,5553,3321,1524,2483,1252,14133,3735
19185,Wayne County,Iowa,4345,292,167,1802,885,546,486,167,3886,653
19187,Webster County,Iowa,25086,474,1580,8445,6102,3288,3861,1336,23032,5197
19189,Winnebago County,Iowa,7203,125,271,2291,1418,1235,1413,450,6807,1863
19191,Winneshiek County,Iowa,13436,295,352,4434,2261,1993,2629,1472,12789,4101
19193,Woodbury County,Iowa,67477,4093,4281,22041,13507,7391,10689,5475,59103,16164
19195,Worth County,Iowa,5340,64,239,1902,1195,899,732,309,5037,1041
19197,Wright County,Iowa,8838,184,460,3123,2227,987,1474,383,8194,1857
20001,Allen County,Kansas,8542,157,472,2975,2326,937,1053,622,7913,1675
20003,Anderson County,Kansas,5228,461,247,2118,1125,479,472,326,4520,798
20005,Atchison County,Kansas,10037,227,398,4206,2236,745,1331,894,9412,2225
20007,Barber County,Kansas,2848,40,201,961,663,310,511,162,2607,673
20009,Barton County,Kansas,17360,477,1320,5277,4684,1839,2657,1106,15563,3763
20011,Bourbon County,Kansas,9399,282,684,2847,2325,1032,1464,765,8433,2229
20013,Brown County,Kansas,6436,84,333,2502,1533,692,964,328,6019,1292
20015,Butler County,Kansas,44550,726,1852,12318,10700,4696,9268,4990,41972,14258
20017,Chase County,Kansas,1817,33,89,655,396,163,374,107,1695,481
20019,Chautauqua County,Kansas,2411,88,183,860,638,251,278,113,2140,391
20021,Cherokee County,Kansas,13410,366,984,4347,3823,1235,1750,905,12060,2655
20023,Cheyenne County,Kansas,1882,57,146,598,493,170,327,91,1679,418
20025,Clark County,Kansas,1355,26,53,368,376,179,287,66,1276,353
20027,Clay County,Kansas,5667,147,179,1973,1416,459,1005,488,5341,1493
20029,Cloud County,Kansas,5961,135,112,1835,1611,931,860,477,5714,1337
20031,Coffey County,Kansas,5894,144,226,1915,1690,611,907,401,5524,1308
20033,Comanche County,Kansas,1305,22,24,410,451,123,222,53,1259,275
20035,Cowley County,Kansas,22925,511,1388,6737,5922,2755,3620,1992,21026,5612
20037,Crawford County,Kansas,23276,494,827,6793,5786,2187,4567,2622,21955,7189
20039,Decatur County,Kansas,2103,34,100,689,537,221,444,78,1969,522
20041,Dickinson County,Kansas,13007,261,575,4127,3558,1427,2186,873,12171,3059
20043,Doniphan County,Kansas,4920,142,293,1654,1455,447,543,386,4485,929
20045,Douglas County,Kansas,69746,1070,1702,13451,12746,4294,20252,16231,66974,36483
20047,Edwards County,Kansas,2069,113,144,726,521,195,280,90,1812,370
20049,Elk County,Kansas,1784,70,163,647,473,106,225,100,1551,325
20051,Ellis County,Kansas,17428,245,567,4858,3443,1567,4187,2561,16616,6748
20053,Ellsworth County,Kansas,4765,66,300,1661,1351,394,666,327,4399,993
20055,Finney County,Kansas,22570,3851,2446,5453,4867,1777,2784,1392,16273,4176
20057,Ford County,Kansas,20445,2757,1901,5201,4323,2219,2581,1463,15787,4044
20059,Franklin County,Kansas,17609,547,858,6390,4061,1538,2586,1629,16204,4215
20061,Geary County,Kansas,19547,537,695,5147,5835,2672,2830,1831,18315,4661
20063,Gove County,Kansas,1883,41,76,741,421,233,287,84,1766,371
20065,Graham County,Kansas,1782,47,63,601,422,215,323,111,1672,434
20067,Grant County,Kansas,4475,859,73,1206,1063,369,585,320,3543,905
20069,Gray County,Kansas,3504,670,194,838,717,318,622,145,2640,767
20071,Greeley County,Kansas,840,75,18,211,160,134,147,95,747,242
20073,Greenwood County,Kansas,4357,124,242,1608,1303,385,455,240,3991,695
20075,Hamilton County,Kansas,1514,99,119,603,289,113,225,66,1296,291
20077,Harper County,Kansas,3652,149,226,1384,1012,243,418,220,3277,638
20079,Harvey County,Kansas,22879,843,1029,5788,5752,2452,4769,2246,21007,7015
20081,Haskell County,Kansas,2432,444,160,623,622,199,237,147,1828,384
20083,Hodgeman County,Kansas,1222,44,46,342,285,132,285,88,1132,373
20085,Jackson County,Kansas,8894,186,363,3383,2397,700,1185,680,8345,1865
20087,Jefferson County,Kansas,12967,227,329,4913,3247,1074,1980,1197,12411,3177
20089,Jewell County,Kansas,2203,26,140,826,577,227,279,128,2037,407
20091,Johnson County,Kansas,415395,6103,8385,58066,76453,30892,142337,93159,400907,235496
20093,Kearny County,Kansas,2361,235,228,857,453,196,246,146,1898,392
20095,Kingman County,Kansas,5213,112,367,1606,1429,431,922,346,4734,1268
20097,Kiowa County,Kansas,1666,56,128,490,372,198,333,89,1482,422
20099,Labette County,Kansas,13649,517,785,4134,3384,1751,1983,1095,12347,3078
20101,Lane County,Kansas,1086,1,45,275,433,116,109,107,1040,216
20103,Leavenworth County,Kansas,55538,1319,2364,15716,11877,4551,11556,8155,51855,19711
20105,Lincoln County,Kansas,2072,54,57,526,684,260,286,205,1961,491
20107,Linn County,Kansas,6885,115,331,2568,1838,514,1013,506,6439,1519
20109,Logan County,Kansas,1909,94,52,550,410,294,385,124,1763,509
20111,Lyon County,Kansas,19281,1283,1063,6214,4215,1357,2966,2183,16935,5149
20113,McPherson County,Kansas,20064,863,609,5031,4970,2296,4250,2045,18592,6295
20115,Marion County,Kansas,8061,252,388,2596,1812,785,1512,716,7421,2228
20117,Marshall County,Kansas,6916,217,323,2683,1459,795,937,502,6376,1439
20119,Meade County,Kansas,2581,167,185,646,604,360,413,206,2229,619
20121,Miami County,Kansas,23390,362,671,7390,5737,2084,4707,2439,22357,7146
20123,Mitchell County,Kansas,3912,43,139,925,1157,521,749,378,3730,1127
20125,Montgomery County,Kansas,21229,543,1580,7167,5226,2441,2811,1461,19106,4272
20127,Morris County,Kansas,3898,82,211,1373,806,339,760,327,3605,1087
20129,Morton County,Kansas,1858,159,67,670,414,222,246,80,1632,326
20131,Nemaha County,Kansas,6634,224,229,2399,1089,818,1248,627,6181,1875
20133,Neosho County,Kansas,10511,273,670,3120,2849,1376,1518,705,9568,2223
20135,Ness County,Kansas,1852,58,102,646,438,221,332,55,1692,387
20137,Norton County,Kansas,3995,81,286,1248,1136,414,592,238,3628,830
20139,Osage County,Kansas,10905,223,637,4444,2454,962,1463,722,10045,2185
20141,Osborne County,Kansas,2515,59,56,800,630,388,439,143,2400,582
20143,Ottawa County,Kansas,4040,45,166,1230,1220,422,693,264,3829,957
20145,Pawnee County,Kansas,4976,120,392,1678,1427,446,626,287,4464,913
20147,Phillips County,Kansas,3498,108,204,1201,850,431,491,213,3186,704
20149,Pottawatomie County,Kansas,16320,92,554,4410,3274,1812,3957,2221,15674,6178
20151,Pratt County,Kansas,5856,146,326,1680,1495,575,1039,595,5384,1634
20153,Rawlins County,Kansas,1854,40,59,561,579,291,249,75,1755,324
20155,Reno County,Kansas,42647,904,2640,13248,11920,5189,5730,3016,39103,8746
20157,Republic County,Kansas,3296,53,100,1057,716,499,552,319,3143,871
20159,Rice County,Kansas,6121,133,355,1804,1807,570,970,482,5633,1452
20161,Riley County,Kansas,35871,597,898,5883,8308,3028,9309,7848,34376,17157
20163,Rooks County,Kansas,3557,50,214,1133,819,534,592,215,3293,807
20165,Rush County,Kansas,2124,43,150,681,625,210,316,99,1931,415
20167,Russell County,Kansas,4778,90,224,1461,1401,638,738,226,4464,964
20169,Saline County,Kansas,36749,525,1783,10890,9553,3628,6655,3715,34441,10370
20171,Scott County,Kansas,3399,243,270,1003,977,229,431,246,2886,677
20173,Sedgwick County,Kansas,340756,14963,20873,87828,79742,29177,68727,39446,304920,108173
20175,Seward County,Kansas,12756,2373,1485,3844,2635,979,1056,384,8898,1440
20177,Shawnee County,Kansas,121415,3186,5410,36578,28139,9555,24726,13821,112819,38547
20179,Sheridan County,Kansas,1675,27,35,580,381,245,296,111,1613,407
20181,Sherman County,Kansas,3718,145,239,1067,867,430,751,219,3334,970
20183,Smith County,Kansas,2641,49,72,1037,575,298,452,158,2520,610
20185,Stafford County,Kansas,2759,61,126,815,652,385,530,190,2572,720
20187,Stanton County,Kansas,1409,182,100,530,218,134,182,63,1127,245
20189,Stevens County,Kansas,3256,320,514,838,900,276,335,73,2422,408
20191,Sumner County,Kansas,15248,261,731,5525,3709,1374,2401,1247,14256,3648
20193,Thomas County,Kansas,4949,92,182,1147,1537,681,822,488,4675,1310
20195,Trego County,Kansas,2143,5,112,665,442,384,400,135,2026,535
20197,Wabaunsee County,Kansas,4790,47,117,1829,1093,501,817,386,4626,1203
20199,Wallace County,Kansas,1022,41,35,295,229,157,215,50,946,265
20201,Washington County,Kansas,3856,105,145,1541,766,430,587,282,3606,869
20203,Wichita County,Kansas,1540,58,124,452,417,159,257,73,1358,330
20205,Wilson County,Kansas,5988,171,349,2241,1364,693,875,295,5468,1170
20207,Woodson County,Kansas,2332,25,161,885,549,220,357,135,2146,492
20209,Wyandotte County,Kansas,106905,10234,9693,34210,22342,9058,13738,7630,86978,21368
21001,Adair County,Kentucky,12713,843,922,5064,2102,1414,1139,1229,10948,2368
21003,Allen County,Kentucky,14374,993,944,5737,2725,1345,1577,1053,12437,2630
21005,Anderson County,Kentucky,16431,627,833,5764,3570,1473,2717,1447,14971,4164
21007,Ballard County,Kentucky,5559,151,287,2256,1068,833,653,311,5121,964
21009,Barren County,Kentucky,30860,2060,2650,12958,5345,2463,3283,2101,26150,5384
21011,Bath County,Kentucky,8467,829,742,3739,1369,572,682,534,6896,1216
21013,Bell County,Kentucky,16982,1566,2140,6841,3009,1445,1219,762,13276,1981
21015,Boone County,Kentucky,89976,2111,3446,26196,18728,8327,19562,11606,84419,31168
21017,Bourbon County,Kentucky,13912,903,1140,4790,2913,933,1784,1449,11869,3233
21019,Boyd County,Kentucky,34293,959,2917,10964,7997,4307,3883,3266,30417,7149
21021,Boyle County,Kentucky,20631,578,1408,7259,4281,1584,3121,2400,18645,5521
21023,Bracken County,Kentucky,5810,242,453,2530,1013,551,647,374,5115,1021
21025,Breathitt County,Kentucky,9773,736,1270,3921,1585,597,803,861,7767,1664
21027,Breckinridge County,Kentucky,14165,643,1467,5962,2913,1149,1161,870,12055,2031
21029,Bullitt County,Kentucky,58451,1734,4481,23832,12554,5593,6606,3651,52236,10257
21031,Butler County,Kentucky,8642,744,921,3973,1467,558,468,511,6977,979
21033,Caldwell County,Kentucky,8871,217,874,3778,1749,822,794,637,7780,1431
21035,Calloway County,Kentucky,23262,792,1469,7413,4582,1671,4109,3226,21001,7335
21037,Campbell County,Kentucky,65046,1357,3007,17249,12431,5460,15843,9699,60682,25542
21039,Carlisle County,Kentucky,3314,167,266,1483,661,295,286,156,2881,442
21041,Carroll County,Kentucky,7117,417,811,3084,1792,603,214,196,5889,410
21043,Carter County,Kentucky,18328,1464,1988,7361,3141,1718,1543,1113,14876,2656
21045,Casey County,Kentucky,11052,1500,1012,4812,1664,714,711,639,8540,1350
21047,Christian County,Kentucky,41333,2200,3456,13349,10225,4210,5406,2487,35677,7893
21049,Clark County,Kentucky,25898,1051,1807,9748,5654,2471,3290,1877,23040,5167
21051,Clay County,Kentucky,14691,2103,1992,5608,2082,809,1060,1037,10596,2097
21053,Clinton County,Kentucky,6593,605,656,2658,1060,691,541,382,5332,923
21055,Crittenden County,Kentucky,6343,370,493,2883,1269,537,472,319,5480,791
21057,Cumberland County,Kentucky,4338,303,549,1869,712,162,503,240,3486,743
21059,Daviess County,Kentucky,69235,1933,4133,23487,14667,7422,10844,6749,63169,17593
21061,Edmonson County,Kentucky,9005,732,926,3918,1811,589,476,553,7347,1029
21063,Elliott County,Kentucky,5561,679,689,2529,811,288,387,178,4193,565
21065,Estill County,Kentucky,10104,1097,1282,4376,1324,902,779,344,7725,1123
21067,Fayette County,Kentucky,209558,6735,9715,39312,39919,16337,54431,43109,193108,97540
21069,Fleming County,Kentucky,10206,807,1088,4331,1436,933,998,613,8311,1611
21071,Floyd County,Kentucky,25186,2227,2989,9887,5071,1725,1906,1381,19970,3287
21073,Franklin County,Kentucky,36106,1310,1604,10700,8094,3003,6670,4725,33192,11395
21075,Fulton County,Kentucky,4570,303,595,1818,990,223,526,115,3672,641
21077,Gallatin County,Kentucky,5886,327,581,2698,1158,355,574,193,4978,767
21079,Garrard County,Kentucky,12270,601,1251,4570,2394,1010,1212,1232,10418,2444
21081,Grant County,Kentucky,16074,464,1315,7177,3504,1083,1625,906,14295,2531
21083,Graves County,Kentucky,24901,820,1641,10322,4694,2783,2646,1995,22440,4641
21085,Grayson County,Kentucky,18029,1148,1815,8049,3314,1314,1353,1036,15066,2389
21087,Green County,Kentucky,8061,785,591,3333,1608,652,554,538,6685,1092
21089,Greenup County,Kentucky,25594,1135,1462,9428,5630,3430,2338,2171,22997,4509
21091,Hancock County,Kentucky,6164,235,554,2524,1059,718,729,345,5375,1074
21093,Hardin County,Kentucky,73850,1629,4050,22842,19620,8037,10567,7105,68171,17672
21095,Harlan County,Kentucky,18583,1642,2641,6680,3783,1882,974,981,14300,1955
21097,Harrison County,Kentucky,13038,519,1235,5599,2402,929,1248,1106,11284,2354
21099,Hart County,Kentucky,13021,1150,1663,5698,2236,907,821,546,10208,1367
21101,Henderson County,Kentucky,31311,960,2402,11726,7473,2845,3763,2142,27949,5905
21103,Henry County,Kentucky,10795,636,1074,4540,2239,714,1045,547,9085,1592
21105,Hickman County,Kentucky,3277,176,205,1269,669,230,572,156,2896,728
21107,Hopkins County,Kentucky,31412,1368,2218,12646,7025,3297,2671,2187,27826,4858
21109,Jackson County,Kentucky,9069,1046,1403,3699,1325,584,626,386,6620,1012
21111,Jefferson County,Kentucky,540624,14562,32488,139213,114307,44823,115392,79839,493574,195231
21113,Jessamine County,Kentucky,35658,1074,2626,11042,6657,3452,6191,4616,31958,10807
21115,Johnson County,Kentucky,15934,977,1764,6553,3063,1256,1291,1030,13193,2321
21117,Kenton County,Kentucky,115530,3341,5957,31462,22306,10336,27047,15081,106232,42128
21119,Knott County,Kentucky,9962,1260,1555,2782,1773,968,746,878,7147,1624
21121,Knox County,Kentucky,20402,2178,2102,7994,3634,1084,1833,1577,16122,3410
21123,Larue County,Kentucky,10425,552,1073,3647,2471,1094,618,970,8800,1588
21125,Laurel County,Kentucky,43093,2546,4359,17345,8388,3305,3840,3310,36188,7150
21127,Lawrence County,Kentucky,11140,1070,1498,4855,1900,607,645,565,8572,1210
21129,Lee County,Kentucky,5345,686,731,2215,1029,292,275,117,3928,392
21131,Leslie County,Kentucky,7227,491,811,2991,1611,488,518,317,5925,835
21133,Letcher County,Kentucky,15377,1487,1751,5537,3083,1506,1134,879,12139,2013
21135,Lewis County,Kentucky,9123,1074,872,4052,1380,817,539,389,7177,928
21137,Lincoln County,Kentucky,16721,1026,1889,7281,2860,1093,1554,1018,13806,2572
21139,Livingston County,Kentucky,6552,244,606,2881,1495,462,487,377,5702,864
21141,Logan County,Kentucky,18804,929,1380,8075,3726,1476,1994,1224,16495,3218
21143,Lyon County,Kentucky,6885,197,456,3209,1292,731,504,496,6232,1000
21145,McCracken County,Kentucky,47460,975,2479,14991,10704,4928,7917,5466,44006,13383
21147,McCreary County,Kentucky,11826,1186,1418,5150,2115,1153,445,359,9222,804
21149,McLean County,Kentucky,6369,261,295,2573,1423,672,709,436,5813,1145
21151,Madison County,Kentucky,57882,2065,3288,16493,11310,5429,11548,7749,52529,19297
21153,Magoffin County,Kentucky,8194,1050,1206,3260,1358,428,299,593,5938,892
21155,Marion County,Kentucky,13358,809,1280,5822,2262,1470,838,877,11269,1715
21157,Marshall County,Kentucky,22997,563,1210,8057,5919,2094,2981,2173,21224,5154
21159,Martin County,Kentucky,8275,941,1104,3052,1504,781,566,327,6230,893
21161,Mason County,Kentucky,11868,803,910,3771,2248,1455,1423,1258,10155,2681
21163,Meade County,Kentucky,20806,671,1488,8239,4694,2006,2143,1565,18647,3708
21165,Menifee County,Kentucky,4391,494,397,1884,784,359,329,144,3500,473
21167,Mercer County,Kentucky,15846,712,854,5574,3518,1756,2070,1362,14280,3432
21169,Metcalfe County,Kentucky,7180,637,562,3035,1339,594,552,461,5981,1013
21171,Monroe County,Kentucky,7836,675,769,3319,1317,504,454,798,6392,1252
21173,Montgomery County,Kentucky,19217,1242,1597,7975,3552,1360,2061,1430,16378,3491
21175,Morgan County,Kentucky,10226,1112,1190,3873,1658,578,928,887,7924,1815
21177,Muhlenberg County,Kentucky,21946,1106,2364,9192,3972,2391,1649,1272,18476,2921
21179,Nelson County,Kentucky,32231,725,1781,11807,6723,3933,4407,2855,29725,7262
21181,Nicholas County,Kentucky,5180,281,672,2352,1007,501,169,198,4227,367
21183,Ohio County,Kentucky,16360,1356,1616,6510,2949,1575,1318,1036,13388,2354
21185,Oldham County,Kentucky,45110,802,1797,8879,8986,4187,11661,8798,42511,20459
21187,Owen County,Kentucky,7895,562,717,3479,953,694,1158,332,6616,1490
21189,Owsley County,Kentucky,3019,481,383,1319,414,87,226,109,2155,335
21191,Pendleton County,Kentucky,10041,432,1020,4334,1698,895,1094,568,8589,1662
21193,Perry County,Kentucky,19595,1648,2343,6730,4248,2035,1139,1452,15604,2591
21195,Pike County,Kentucky,41556,3805,4607,16075,7336,3147,3511,3075,33144,6586
21197,Powell County,Kentucky,8915,707,906,3879,1481,599,835,508,7302,1343
21199,Pulaski County,Kentucky,45989,3381,4080,16108,9904,4335,4560,3621,38528,8181
21201,Robertson County,Kentucky,1525,101,140,596,304,198,149,37,1284,186
21203,Rockcastle County,Kentucky,11492,956,1122,5225,2264,541,640,744,9414,1384
21205,Rowan County,Kentucky,14254,798,1085,4870,2664,977,1812,2048,12371,3860
21207,Russell County,Kentucky,12422,952,1200,4791,2202,1235,1124,918,10270,2042
21209,Scott County,Kentucky,37778,655,1507,11051,9044,3475,7371,4675,35616,12046
21211,Shelby County,Kentucky,33524,1333,2505,10095,6223,3239,6244,3885,29686,10129
21213,Simpson County,Kentucky,13236,309,985,5812,2632,1572,1111,815,11942,1926
21215,Spencer County,Kentucky,13533,308,699,5306,2936,1297,1924,1063,12526,2987
21217,Taylor County,Kentucky,17026,693,1286,5938,3852,1342,2425,1490,15047,3915
21219,Todd County,Kentucky,7977,963,748,3090,1322,541,756,557,6266,1313
21221,Trigg County,Kentucky,10082,492,733,3254,2554,984,1196,869,8857,2065
21223,Trimble County,Kentucky,6012,132,737,2598,954,769,560,262,5143,822
21225,Union County,Kentucky,9388,270,615,4282,1939,1325,608,349,8503,957
21227,Warren County,Kentucky,82837,4579,4871,22577,16371,7159,16718,10562,73387,27280
21229,Washington County,Kentucky,8394,517,479,3560,1477,700,921,740,7398,1661
21231,Wayne County,Kentucky,14032,1751,1555,5556,2311,919,1067,873,10726,1940
21233,Webster County,Kentucky,8802,455,806,4084,1629,820,635,373,7541,1008
21235,Whitley County,Kentucky,23180,1478,2679,9128,4308,1250,2180,2157,19023,4337
21237,Wolfe County,Kentucky,4484,647,986,1459,835,241,104,212,2851,316
21239,Woodford County,Kentucky,18670,545,1096,4893,2953,1592,4579,3012,17029,7591
22001,Acadia Parish,Louisiana,38069,3288,4285,16574,5854,2851,3777,1440,30496,5217
22003,Allen Parish,Louisiana,15864,853,2381,6875,2819,1025,1285,626,12630,1911
22005,Ascension Parish,Louisiana,83300,3041,6288,24518,17819,7449,16316,7869,73971,24185
22007,Assumption Parish,Louisiana,14783,1188,1906,6496,2496,710,1217,770,11689,1987
22009,Avoyelles Parish,Louisiana,26893,1820,4100,9639,6016,2016,2002,1300,20973,3302
22011,Beauregard Parish,Louisiana,24280,941,1934,9864,5110,2089,2961,1381,21405,4342
22013,Bienville Parish,Louisiana,9118,309,997,4393,1672,618,823,306,7812,1129
22015,Bossier Parish,Louisiana,86122,2402,5979,25210,20975,7810,15201,8545,77741,23746
22017,Caddo Parish,Louisiana,160866,5500,14956,52474,36907,11959,22890,16180,140410,39070
22019,Calcasieu Parish,Louisiana,139900,4426,11382,47620,30868,12651,21647,11306,124092,32953
22021,Caldwell Parish,Louisiana,6877,436,944,3348,1069,251,640,189,5497,829
22023,Cameron Parish,Louisiana,3945,90,293,1614,1059,321,384,184,3562,568
22025,Catahoula Parish,Louisiana,6294,513,1061,2549,797,269,693,412,4720,1105
22027,Claiborne Parish,Louisiana,10359,460,1764,4866,1685,377,786,421,8135,1207
22029,Concordia Parish,Louisiana,12394,648,1113,5486,2113,857,1390,787,10633,2177
22031,De Soto Parish,Louisiana,18435,1061,2186,7303,3330,1546,2027,982,15188,3009
22033,East Baton Rouge Parish,Louisiana,284666,8705,17380,73875,59730,16285,64684,44007,258581,108691
22035,East Carroll Parish,Louisiana,4833,318,1242,1684,861,158,481,89,3273,570
22037,East Feliciana Parish,Louisiana,14659,413,1877,6167,2679,1159,1750,614,12369,2364
22039,Evangeline Parish,Louisiana,20961,2142,2782,8506,3564,1404,1961,602,16037,2563
22041,Franklin Parish,Louisiana,13110,1063,1794,5524,2064,653,1302,710,10253,2012
22043,Grant Parish,Louisiana,15725,957,2118,6788,2954,1017,1440,451,12650,1891
22045,Iberia Parish,Louisiana,45952,2580,5364,19259,8329,3915,4873,1632,38008,6505
22047,Iberville Parish,Louisiana,21396,1762,2584,8115,3552,2189,2067,1127,17050,3194
22049,Jackson Parish,Louisiana,10772,532,1272,4735,1889,962,987,395,8968,1382
22051,Jefferson Parish,Louisiana,306562,16187,23021,86951,68096,21017,59420,31870,267354,91290
22053,Jefferson Davis Parish,Louisiana,21465,1264,2357,9106,4152,1323,1963,1300,17844,3263
22055,Lafayette Parish,Louisiana,164601,5619,11591,48135,31806,10438,38795,18217,147391,57012
22057,Lafourche Parish,Louisiana,66341,4657,7261,26838,10891,4342,8279,4073,54423,12352
22059,LaSalle Parish,Louisiana,9974,509,1198,3976,1690,836,1196,569,8267,1765
22061,Lincoln Parish,Louisiana,26298,849,2134,7726,4557,1414,5494,4124,23315,9618
22063,Livingston Parish,Louisiana,94939,3646,7091,34933,21724,6907,14911,5727,84202,20638
22065,Madison Parish,Louisiana,6497,476,1051,2213,1568,278,672,239,4970,911
22067,Morehouse Parish,Louisiana,17377,1128,2183,6696,3542,1592,1478,758,14066,2236
22069,Natchitoches Parish,Louisiana,22411,592,2199,8529,3990,1984,3018,2099,19620,5117
22071,Orleans Parish,Louisiana,270382,9275,21329,58967,57324,13345,60578,49564,239778,110142
22073,Ouachita Parish,Louisiana,104662,3333,9220,33982,24942,6158,17102,9925,92109,27027
22075,Plaquemines Parish,Louisiana,15539,1152,978,4912,4342,1202,2016,937,13409,2953
22077,Pointe Coupee Parish,Louisiana,14640,1123,1658,5422,3115,1159,1657,506,11859,2163
22079,Rapides Parish,Louisiana,86319,3615,7057,32361,18126,5910,12220,7030,75647,19250
22081,Red River Parish,Louisiana,5092,200,838,2512,746,254,363,179,4054,542
22083,Richland Parish,Louisiana,13493,699,1982,5283,2560,765,1315,889,10812,2204
22085,Sabine Parish,Louisiana,15114,637,1504,6988,3043,930,1484,528,12973,2012
22087,St. Bernard Parish,Louisiana,29124,1527,3956,8591,7607,2543,3315,1585,23641,4900
22089,St. Charles Parish,Louisiana,35224,1013,2266,11232,7940,3205,7025,2543,31945,9568
22091,St. Helena Parish,Louisiana,7441,512,1041,3443,1190,361,616,278,5888,894
22093,St. James Parish,Louisiana,14008,328,1228,5564,2853,1420,1779,836,12452,2615
22095,St. John the Baptist Parish,Louisiana,27757,845,2927,11418,5519,2502,2863,1683,23985,4546
22097,St. Landry Parish,Louisiana,53626,4359,7144,21250,9667,3636,4931,2639,42123,7570
22099,St. Martin Parish,Louisiana,35192,2155,3901,16223,5940,1976,3615,1382,29136,4997
22101,St. Mary Parish,Louisiana,33751,2186,4538,15345,5374,2149,2823,1336,27027,4159
22103,St. Tammany Parish,Louisiana,182793,5550,10437,43794,42755,13744,42984,23529,166806,66513
22105,Tangipahoa Parish,Louisiana,87535,5501,9162,31451,16444,6164,12831,5982,72872,18813
22107,Tensas Parish,Louisiana,2947,150,488,1302,497,91,262,157,2309,419
22109,Terrebonne Parish,Louisiana,72589,5353,7441,28240,14446,4735,8098,4276,59795,12374
22111,Union Parish,Louisiana,14883,515,1581,6407,3057,738,2025,560,12787,2585
22113,Vermilion Parish,Louisiana,38106,1958,3834,15458,6777,2938,5270,1871,32314,7141
22115,Vernon Parish,Louisiana,30151,1082,2599,11839,6675,2308,4115,1533,26470,5648
22117,Washington Parish,Louisiana,31322,1702,3601,14477,5990,1881,2493,1178,26019,3671
22119,Webster Parish,Louisiana,25447,1120,2270,10969,5220,2202,2582,1084,22057,3666
22121,West Baton Rouge Parish,Louisiana,19426,599,1624,7176,4096,1447,3287,1197,17203,4484
22123,West Carroll Parish,Louisiana,6839,488,771,3201,1379,218,469,313,5580,782
22125,West Feliciana Parish,Louisiana,11898,585,1396,4473,2290,636,1709,809,9917,2518
22127,Winn Parish,Louisiana,9808,580,998,4593,1757,578,844,458,8230,1302
23001,Androscoggin County,Maine,77350,2582,3628,27558,16245,9695,11847,5795,71140,17642
23003,Aroostook County,Maine,50230,1931,2778,19380,10041,5350,7343,3407,45521,10750
23005,Cumberland County,Maine,222300,3212,5120,45860,36231,19332,67158,45387,213968,112545
23007,Franklin County,Maine,21486,191,1120,7745,4151,2096,4035,2148,20175,6183
23009,Hancock County,Maine,42391,615,1484,12976,7870,3933,9856,5657,40292,15513
23011,Kennebec County,Maine,90019,1764,3131,31763,17784,8689,16692,10196,85124,26888
23013,Knox County,Maine,31106,446,1518,9495,5433,2440,7362,4412,29142,11774
23015,Lincoln County,Maine,27325,385,1040,8508,4473,2200,6501,4218,25900,10719
23017,Oxford County,Maine,44069,1014,2898,18027,7536,5128,6398,3068,40157,9466
23019,Penobscot County,Maine,110023,2003,4683,36191,21695,12682,20779,11990,103337,32769
23021,Piscataquis County,Maine,13075,486,559,4869,2889,1548,1990,734,12030,2724
23023,Sagadahoc County,Maine,27860,512,1077,7765,5020,2716,6223,4547,26271,10770
23025,Somerset County,Maine,37813,940,2160,15827,7050,4369,5392,2075,34713,7467
23027,Waldo County,Maine,29692,527,1506,9614,5537,2632,5948,3928,27659,9876
23029,Washington County,Maine,23012,732,1354,8252,4773,2234,3643,2024,20926,5667
23031,York County,Maine,158210,2347,6017,47765,31482,18090,33566,18943,149846,52509
24001,Allegany County,Maryland,47914,1036,3491,19476,9287,4645,5726,4253,43387,9979
24003,Anne Arundel County,Maryland,409052,9100,17301,89780,82389,29970,102712,77800,382651,180512
24005,Baltimore County,Maryland,589611,19201,29656,143462,111509,43084,136268,106431,540754,242699
24009,Calvert County,Maryland,64176,730,2817,18293,13931,5574,12420,10411,60629,22831
24011,Caroline County,Maryland,22837,1226,2332,9012,4772,1451,2362,1682,19279,4044
24013,Carroll County,Maryland,120559,2089,4926,33969,22611,10242,28729,17993,113544,46722
24015,Cecil County,Maryland,72203,1663,4511,26216,14847,5650,11804,7512,66029,19316
24017,Charles County,Maryland,112613,2386,3870,34021,27325,10034,20490,14487,106357,34977
24019,Dorchester County,Maryland,23327,810,2045,9410,4914,1680,2425,2043,20472,4468
24021,Frederick County,Maryland,186771,5864,6707,43730,33238,15753,45788,35691,174200,81479
24023,Garrett County,Maryland,21440,634,1400,8779,3330,2018,2893,2386,19406,5279
24025,Harford County,Maryland,182063,3120,7495,47619,37683,15556,40140,30450,171448,70590
24027,Howard County,Maryland,225256,5088,5666,28276,29247,12789,69388,74802,214502,144190
24029,Kent County,Maryland,13958,334,987,4502,2141,780,2939,2275,12637,5214
24031,Montgomery County,Maryland,729862,36062,27754,97385,90394,40143,198924,239200,666046,438124
24033,Prince George's County,Maryland,656203,46553,37833,164184,131401,42400,131451,102381,571817,233832
24035,Queen Anne's County,Maryland,36066,583,1847,10461,7193,2792,8244,4946,33636,13190
24037,St. Mary's County,Maryland,76139,2000,4231,22504,15076,5742,15055,11531,69908,26586
24039,Somerset County,Maryland,16964,541,2061,6585,3600,1319,1965,893,14362,2858
24041,Talbot County,Maryland,28623,663,1569,6838,5604,2084,6565,5300,26391,11865
24043,Washington County,Maryland,108258,3359,9164,39512,22661,8688,14675,10199,95735,24874
24045,Wicomico County,Maryland,65721,2467,5060,21034,12684,5451,11476,7549,58194,19025
24047,Worcester County,Maryland,40258,639,1971,12135,9510,3085,8043,4875,37648,12918
24510,Baltimore city,Maryland,410221,16276,36799,115541,77271,21160,72434,70740,357146,143174
25001,Barnstable County,Massachusetts,180261,2646,4741,38497,33291,18065,45373,37648,172874,83021
25003,Berkshire County,Massachusetts,95692,1976,4338,27586,17188,8284,19592,16728,89378,36320
25005,Bristol County,Massachusetts,407256,28467,28189,124191,68194,37325,78287,42603,350600,120890
25007,Dukes County,Massachusetts,15726,444,470,4005,2711,1308,3694,3094,14812,6788
25009,Essex County,Massachusetts,562867,29310,27295,136332,88157,46812,138834,96127,506262,234961
25011,Franklin County,Massachusetts,54094,968,2447,14618,8958,5573,11539,9991,50679,21530
25013,Hampden County,Massachusetts,318443,16847,25633,95869,57648,31220,54812,36414,275963,91226
25015,Hampshire County,Massachusetts,99735,1678,3072,20862,14953,8902,24676,25592,94985,50268
25017,Middlesex County,Massachusetts,1145170,38122,37182,201851,132436,66029,330386,339164,1069866,669550
25019,Nantucket County,Massachusetts,9942,183,88,1708,1718,541,3481,2223,9671,5704
25021,Norfolk County,Massachusetts,509433,15027,14325,91524,66223,35552,148960,137822,480081,286782
25023,Plymouth County,Massachusetts,372525,11863,13794,99149,62515,34172,93963,57069,346868,151032
25025,Suffolk County,Massachusetts,551133,41857,29206,112380,68836,27486,146861,124507,480070,271368
25027,Worcester County,Massachusetts,597824,20588,30831,159327,104096,53611,133862,95509,546405,229371
26001,Alcona County,Michigan,8440,166,575,3261,1947,805,1041,645,7699,1686
26003,Alger County,Michigan,6562,125,286,2800,1438,554,965,394,6151,1359
26005,Allegan County,Michigan,82354,2015,4841,30099,18501,7023,13239,6636,75498,19875
26007,Alpena County,Michigan,21535,439,1113,7804,5448,3128,2221,1382,19983,3603
26009,Antrim County,Michigan,18006,322,713,5260,4095,1773,3587,2256,16971,5843
26011,Arenac County,Michigan,11313,253,950,4212,2882,1367,1088,561,10110,1649
26013,Baraga County,Michigan,6254,138,406,2449,1610,678,645,328,5710,973
26015,Barry County,Michigan,44172,911,2125,16143,10509,4046,7242,3196,41136,10438
26017,Bay County,Michigan,75152,1665,5120,25312,18784,9176,10450,4645,68367,15095
26019,Benzie County,Michigan,13789,287,617,4078,3033,1301,2713,1760,12885,4473
26021,Berrien County,Michigan,108050,2777,6264,29889,25577,11046,19850,12647,99009,32497
26023,Branch County,Michigan,30962,1726,1737,12304,7270,2952,3486,1487,27499,4973
26025,Calhoun County,Michigan,91454,2294,5810,32182,22072,8935,13238,6923,83350,20161
26027,Cass County,Michigan,36887,958,2850,12511,8622,4138,5032,2776,33079,7808
26029,Charlevoix County,Michigan,19558,229,808,5394,4556,2119,3914,2538,18521,6452
26031,Cheboygan County,Michigan,19958,381,1675,6893,4440,2077,2667,1825,17902,4492
26033,Chippewa County,Michigan,25632,486,1495,8741,6724,2325,3700,2161,23651,5861
26035,Clare County,Michigan,22771,1022,1913,9193,5514,2359,1650,1120,19836,2770
26037,Clinton County,Michigan,55160,1003,1697,14157,13622,6896,11239,6546,52460,17785
26039,Crawford County,Michigan,10082,150,758,3242,2719,1240,1192,781,9174,1973
26041,Delta County,Michigan,27183,313,1772,9657,6055,4031,3750,1605,25098,5355
26043,Dickinson County,Michigan,19042,106,660,6166,4929,2634,3142,1405,18276,4547
26045,Eaton County,Michigan,77481,1317,2740,20753,20574,8638,15772,7687,73424,23459
26047,Emmet County,Michigan,24986,235,877,6385,5484,2541,5539,3925,23874,9464
26049,Genesee County,Michigan,280153,6473,18749,88020,72485,30588,41339,22499,254931,63838
26051,Gladwin County,Michigan,18968,844,1233,7245,4994,1926,1784,942,16891,2726
26053,Gogebic County,Michigan,11325,96,334,3714,2752,1896,1667,866,10895,2533
26055,Grand Traverse County,Michigan,68969,1017,2500,15378,15809,7601,15878,10786,65452,26664
26057,Gratiot County,Michigan,28563,684,1631,11594,6969,2507,3514,1664,26248,5178
26059,Hillsdale County,Michigan,31504,1142,1916,12885,6738,2660,3631,2532,28446,6163
26061,Houghton County,Michigan,21681,387,866,6514,4317,1841,4125,3631,20428,7756
26063,Huron County,Michigan,23224,579,1433,9836,4822,2700,2558,1296,21212,3854
26065,Ingham County,Michigan,174119,3844,7330,37312,38787,16083,38966,31797,162945,70763
26067,Ionia County,Michigan,46270,1129,2890,18381,11359,4717,5605,2189,42251,7794
26069,Iosco County,Michigan,19618,353,1644,7347,5059,2012,1882,1321,17621,3203
26071,Iron County,Michigan,8930,148,501,3771,1835,902,1147,626,8281,1773
26073,Isabella County,Michigan,36064,957,1698,11139,8003,3212,5938,5117,33409,11055
26075,Jackson County,Michigan,112132,1991,6969,39774,26420,11769,16714,8495,103172,25209
26077,Kalamazoo County,Michigan,164896,2633,6657,37797,35811,15244,40547,26207,155606,66754
26079,Kalkaska County,Michigan,12992,324,1177,4967,3206,1065,1403,850,11491,2253
26081,Kent County,Michigan,438030,14187,19042,104903,90667,40200,108970,60061,404801,169031
26083,Keweenaw County,Michigan,1734,20,13,495,338,204,379,285,1701,664
26085,Lake County,Michigan,9642,471,1240,3981,2163,615,851,321,7931,1172
26087,Lapeer County,Michigan,63664,1446,3660,23276,16231,6886,8065,4100,58558,12165
26089,Leelanau County,Michigan,17562,161,498,3425,3254,1682,4935,3607,16903,8542
26091,Lenawee County,Michigan,69488,1671,4493,24831,15926,6946,10011,5610,63324,15621
26093,Livingston County,Michigan,138319,1236,4180,34417,31979,13753,35752,17002,132903,52754
26095,Luce County,Michigan,4125,74,266,1659,932,481,411,302,3785,713
26097,Mackinac County,Michigan,8510,175,452,3093,1940,661,1360,829,7883,2189
26099,Macomb County,Michigan,623718,21105,37331,182377,148987,66757,107738,59423,565282,167161
26101,Manistee County,Michigan,19067,447,1400,6276,4779,1871,3016,1278,17220,4294
26103,Marquette County,Michigan,44267,387,1644,12501,9785,4596,10526,4828,42236,15354
26105,Mason County,Michigan,21299,384,1000,7370,4653,2737,3067,2088,19915,5155
26107,Mecosta County,Michigan,26586,626,1513,9973,5775,2385,3940,2374,24447,6314
26109,Menominee County,Michigan,17526,411,874,7436,3735,2151,1952,967,16241,2919
26111,Midland County,Michigan,59321,773,2201,16490,11782,6943,12630,8502,56347,21132
26113,Missaukee County,Michigan,10645,252,775,4381,2269,1173,1263,532,9618,1795
26115,Monroe County,Michigan,109932,1978,7179,36697,26312,12924,15952,8890,100775,24842
26117,Montcalm County,Michigan,47374,1571,4049,19125,11157,4667,4683,2122,41754,6805
26119,Montmorency County,Michigan,7334,154,715,2921,1674,756,741,373,6465,1114
26121,Muskegon County,Michigan,121491,2923,6622,42794,29253,14758,17502,7639,111946,25141
26123,Newaygo County,Michigan,35223,1092,2631,14103,7572,3394,4372,2059,31500,6431
26125,Oakland County,Michigan,906930,16905,30758,163353,171713,74960,253140,196101,859267,449241
26127,Oceana County,Michigan,18800,715,1224,7126,4122,1929,2357,1327,16861,3684
26129,Ogemaw County,Michigan,15698,320,1536,5960,3793,1802,1535,752,13842,2287
26131,Ontonagon County,Michigan,4866,53,259,2080,1163,571,502,238,4554,740
26133,Osceola County,Michigan,16242,600,1135,6458,3783,1580,1796,890,14507,2686
26135,Oscoda County,Michigan,6160,335,563,2321,1611,481,579,270,5262,849
26137,Otsego County,Michigan,18112,315,710,5805,4506,2020,3142,1614,17087,4756
26139,Ottawa County,Michigan,186701,3652,7217,49693,39172,18826,45105,23036,175832,68141
26141,Presque Isle County,Michigan,10295,248,565,3784,2402,1254,1389,653,9482,2042
26143,Roscommon County,Michigan,18908,434,1327,6386,5027,2234,1983,1517,17147,3500
26145,Saginaw County,Michigan,131068,3021,9366,42801,30797,15099,19474,10510,118681,29984
26147,St. Clair County,Michigan,114600,2028,7230,38260,30052,14230,14300,8500,105342,22800
26149,St. Joseph County,Michigan,41125,2487,2767,14849,9694,4262,4415,2651,35871,7066
26151,Sanilac County,Michigan,29066,899,1759,12448,6608,2913,2940,1499,26408,4439
26153,Schoolcraft County,Michigan,6193,185,499,2369,1249,644,807,440,5509,1247
26155,Shiawassee County,Michigan,48507,887,2942,16666,13003,5707,6225,3077,44678,9302
26157,Tuscola County,Michigan,38485,735,2523,17495,7950,3892,3977,1913,35227,5890
26159,Van Buren County,Michigan,52266,2344,3703,17073,12260,5272,7423,4191,46219,11614
26161,Washtenaw County,Michigan,234408,3248,6686,33787,40218,15883,62954,71632,224474,134586
26163,Wayne County,Michigan,1205390,47044,100244,356264,279683,102753,192328,127074,1058102,319402
26165,Wexford County,Michigan,23571,612,1751,8557,5578,2393,3061,1619,21208,4680
27001,Aitkin County,Minnesota,12381,195,724,4610,3078,1503,1552,719,11462,2271
27003,Anoka County,Minnesota,249064,5723,8792,68226,56417,31567,56466,21873,234549,78339
27005,Becker County,Minnesota,24188,493,1166,6967,5656,3543,4375,1988,22529,6363
27007,Beltrami County,Minnesota,28737,540,1633,7629,6235,3665,5532,3503,26564,9035
27009,Benton County,Minnesota,27275,548,1729,7864,6512,4172,4502,1948,24998,6450
27011,Big Stone County,Minnesota,3746,121,128,1459,669,607,475,287,3497,762
27013,Blue Earth County,Minnesota,40559,830,1265,10060,8315,5827,9412,4850,38464,14262
27015,Brown County,Minnesota,17713,386,857,6236,3869,2125,3020,1220,16470,4240
27017,Carlton County,Minnesota,25604,502,1001,8085,6142,3448,4272,2154,24101,6426
27019,Carver County,Minnesota,70801,1334,1290,12726,12259,7960,23365,11867,68177,35232
27021,Cass County,Minnesota,22211,350,1008,7051,5628,2655,3915,1604,20853,5519
27023,Chippewa County,Minnesota,8611,296,502,2871,1877,1361,1134,570,7813,1704
27025,Chisago County,Minnesota,39754,396,1514,12787,9621,6065,6656,2715,37844,9371
27027,Clay County,Minnesota,39868,810,1480,9066,8162,5724,9991,4635,37578,14626
27029,Clearwater County,Minnesota,5793,207,513,2139,1240,636,748,310,5073,1058
27031,Cook County,Minnesota,4502,22,104,1045,810,432,1266,823,4376,2089
27033,Cottonwood County,Minnesota,7800,256,422,2647,1747,972,1318,438,7122,1756
27035,Crow Wing County,Minnesota,48098,556,2182,13935,11963,6400,8574,4488,45360,13062
27037,Dakota County,Minnesota,298459,5352,7835,58947,59502,35140,89817,41866,285272,131683
27039,Dodge County,Minnesota,13896,172,418,4082,2828,2185,3107,1104,13306,4211
27041,Douglas County,Minnesota,27956,393,823,8397,5416,4986,5526,2415,26740,7941
27043,Faribault County,Minnesota,9905,197,471,3361,2369,1387,1615,505,9237,2120
27045,Fillmore County,Minnesota,14574,552,631,4644,3157,2195,2279,1116,13391,3395
27047,Freeborn County,Minnesota,21959,1019,1503,7335,5185,3168,2625,1124,19437,3749
27049,Goodhue County,Minnesota,33717,512,1350,11299,6916,4270,6173,3197,31855,9370
27051,Grant County,Minnesota,4339,68,224,1380,1050,791,606,220,4047,826
27053,Hennepin County,Minnesota,885895,28785,25960,135977,153486,75989,292492,173206,831150,465698
27055,Houston County,Minnesota,13482,161,538,4498,2473,2215,2685,912,12783,3597
27057,Hubbard County,Minnesota,15654,185,736,4404,3595,2102,3032,1600,14733,4632
27059,Isanti County,Minnesota,28725,433,1732,9941,7480,3480,4173,1486,26560,5659
27061,Itasca County,Minnesota,32773,316,1514,9947,8125,4785,5232,2854,30943,8086
27063,Jackson County,Minnesota,7176,139,331,2407,1569,1074,1255,401,6706,1656
27065,Kanabec County,Minnesota,11514,307,691,4467,3092,1232,1074,651,10516,1725
27067,Kandiyohi County,Minnesota,29348,1605,1291,7896,6532,4424,5365,2235,26452,7600
27069,Kittson County,Minnesota,2981,59,59,1061,659,332,563,248,2863,811
27071,Koochiching County,Minnesota,9123,153,512,3035,2580,1285,1188,370,8458,1558
27073,Lac qui Parle County,Minnesota,4894,52,236,1807,1062,720,770,247,4606,1017
27075,Lake County,Minnesota,8206,113,472,2524,1789,1170,1397,741,7621,2138
27077,Lake of the Woods County,Minnesota,2906,11,105,934,864,375,466,151,2790,617
27079,Le Sueur County,Minnesota,19934,289,736,6711,4341,2941,3466,1450,18909,4916
27081,Lincoln County,Minnesota,3946,107,159,1414,861,523,619,263,3680,882
27083,Lyon County,Minnesota,16191,536,626,4554,3860,2161,3203,1251,15029,4454
27085,McLeod County,Minnesota,25543,426,1232,8779,6153,4122,3176,1655,23885,4831
27087,Mahnomen County,Minnesota,3239,114,309,1141,830,401,314,130,2816,444
27089,Marshall County,Minnesota,6311,138,329,2466,1340,870,917,251,5844,1168
27091,Martin County,Minnesota,14226,275,574,4839,3311,1944,2185,1098,13377,3283
27093,Meeker County,Minnesota,15925,247,695,5639,3655,2499,2195,995,14983,3190
27095,Mille Lacs County,Minnesota,18447,365,1360,6736,4389,2524,2083,990,16722,3073
27097,Morrison County,Minnesota,23694,552,1250,9255,5293,3205,2922,1217,21892,4139
27099,Mower County,Minnesota,26677,1229,1181,9090,5480,3298,4275,2124,24267,6399
27101,Murray County,Minnesota,5815,201,309,2082,1267,701,971,284,5305,1255
27103,Nicollet County,Minnesota,22326,305,791,5514,4631,3292,5191,2602,21230,7793
27105,Nobles County,Minnesota,13986,2079,806,4361,2881,1475,1841,543,11101,2384
27107,Norman County,Minnesota,4463,126,194,1489,937,741,786,190,4143,976
27109,Olmsted County,Minnesota,109809,2710,2855,21574,17363,12968,29258,23081,104244,52339
27111,Otter Tail County,Minnesota,42869,1128,1795,11618,10008,6934,7778,3608,39946,11386
27113,Pennington County,Minnesota,9696,117,339,2926,2143,2265,1391,515,9240,1906
27115,Pine County,Minnesota,21460,409,1484,8776,4846,2641,2317,987,19567,3304
27117,Pipestone County,Minnesota,6244,168,289,2291,1420,795,882,399,5787,1281
27119,Polk County,Minnesota,20982,538,841,6134,4899,2975,4095,1500,19603,5595
27121,Pope County,Minnesota,8222,167,225,2517,1911,1561,1249,592,7830,1841
27123,Ramsey County,Minnesota,367944,17736,14670,74546,64269,32163,99680,64880,335538,164560
27125,Red Lake County,Minnesota,2734,50,86,997,669,458,393,81,2598,474
27127,Redwood County,Minnesota,10368,266,459,3749,2603,1217,1560,514,9643,2074
27129,Renville County,Minnesota,10268,270,616,3588,2521,1429,1448,396,9382,1844
27131,Rice County,Minnesota,43025,1248,1992,13897,8203,4798,8107,4780,39785,12887
27133,Rock County,Minnesota,6488,142,249,2167,1368,783,1295,484,6097,1779
27135,Roseau County,Minnesota,10505,200,542,3932,2471,1262,1672,426,9763,2098
27137,St. Louis County,Minnesota,137528,1921,5101,34947,33921,18082,27655,15901,130506,43556
27139,Scott County,Minnesota,98511,2231,2788,19960,18133,13161,29695,12543,93492,42238
27141,Sherburne County,Minnesota,64190,1019,2574,18231,15554,9310,12484,5018,60597,17502
27143,Sibley County,Minnesota,10409,306,407,3910,2548,1380,1492,366,9696,1858
27145,Stearns County,Minnesota,97939,3640,3503,26819,22030,14088,18295,9564,90796,27859
27147,Steele County,Minnesota,25211,569,1284,7647,5671,2892,4713,2435,23358,7148
27149,Stevens County,Minnesota,5784,201,169,1777,1203,779,1174,481,5414,1655
27151,Swift County,Minnesota,6827,223,247,2206,1587,1002,1298,264,6357,1562
27153,Todd County,Minnesota,17552,963,963,7134,3771,2117,1838,766,15626,2604
27155,Traverse County,Minnesota,2341,57,87,861,511,446,278,101,2197,379
27157,Wabasha County,Minnesota,15468,360,488,5032,3179,2279,2839,1291,14620,4130
27159,Wadena County,Minnesota,9372,249,456,3311,2155,1480,1351,370,8667,1721
27161,Waseca County,Minnesota,13088,252,674,4594,2780,1913,2150,725,12162,2875
27163,Washington County,Minnesota,182135,2558,4369,34642,34312,19028,56173,31053,175208,87226
27165,Watonwan County,Minnesota,7565,544,377,2624,1852,792,1024,352,6644,1376
27167,Wilkin County,Minnesota,4515,88,213,1391,967,763,847,246,4214,1093
27169,Winona County,Minnesota,31020,680,1445,8219,6267,4546,6520,3343,28895,9863
27171,Wright County,Minnesota,92801,1256,3451,26100,19325,11965,21553,9151,88094,30704
27173,Yellow Medicine County,Minnesota,6612,144,346,2162,1582,1096,932,350,6122,1282
28001,Adams County,Mississippi,20302,1228,2321,6714,4117,1803,2428,1691,16753,4119
28003,Alcorn County,Mississippi,24069,1692,2665,8200,5048,2224,2716,1524,19712,4240
28005,Amite County,Mississippi,9134,155,983,3860,2122,1170,403,441,7996,844
28007,Attala County,Mississippi,11712,623,1241,4300,2372,1280,1345,551,9848,1896
28009,Benton County,Mississippi,5418,498,694,1830,1354,446,331,265,4226,596
28011,Bolivar County,Mississippi,20052,1301,2262,5084,3753,2204,3006,2442,16489,5448
28013,Calhoun County,Mississippi,9191,613,1380,3208,1823,1068,699,400,7198,1099
28015,Carroll County,Mississippi,7391,490,1076,2309,1375,811,1043,287,5825,1330
28017,Chickasaw County,Mississippi,11468,911,1837,3872,2365,1190,963,330,8720,1293
28019,Choctaw County,Mississippi,5759,113,639,2396,997,616,576,422,5007,998
28021,Claiborne County,Mississippi,5119,245,669,1504,1204,356,432,709,4205,1141
28023,Clarke County,Mississippi,10758,411,1131,3860,2541,1451,922,442,9216,1364
28025,Clay County,Mississippi,12731,680,1653,4246,2258,1601,1443,850,10398,2293
28027,Coahoma County,Mississippi,13433,1125,1388,3265,3355,1609,1699,992,10920,2691
28029,Copiah County,Mississippi,18528,919,1881,5904,3730,2140,2874,1080,15728,3954
28031,Covington County,Mississippi,12184,562,1527,3935,2735,1511,1336,578,10095,1914
28033,DeSoto County,Mississippi,122411,3709,7047,35282,28996,13778,22045,11554,111655,33599
28035,Forrest County,Mississippi,47240,1306,3645,12377,10908,5463,7234,6307,42289,13541
28037,Franklin County,Mississippi,5254,396,428,1650,1308,606,621,245,4430,866
28039,George County,Mississippi,16155,672,1586,5846,3571,1893,1891,696,13897,2587
28041,Greene County,Mississippi,10020,624,1268,3826,2402,762,723,415,8128,1138
28043,Grenada County,Mississippi,14635,638,1991,4661,2674,1440,1936,1295,12006,3231
28045,Hancock County,Mississippi,33638,860,2381,10149,8405,3647,4431,3765,30397,8196
28047,Harrison County,Mississippi,140048,4447,10825,40050,32687,17305,21413,13321,124776,34734
28049,Hinds County,Mississippi,147715,5342,10997,33959,36153,14994,26376,19894,131376,46270
28051,Holmes County,Mississippi,10747,687,1351,3834,2642,648,1149,436,8709,1585
28053,Humphreys County,Mississippi,5085,398,885,1459,909,487,469,478,3802,947
28055,Issaquena County,Mississippi,1046,99,274,418,144,57,30,24,673,54
28057,Itawamba County,Mississippi,15997,754,1606,5561,4079,1556,1438,1003,13637,2441
28059,Jackson County,Mississippi,98824,4248,6882,27369,25262,11744,15190,8129,87694,23319
28061,Jasper County,Mississippi,11321,314,973,4923,2333,1091,1213,474,10034,1687
28063,Jefferson County,Mississippi,4926,532,657,1501,1059,205,519,453,3737,972
28065,Jefferson Davis County,Mississippi,8072,359,812,3239,1659,860,567,576,6901,1143
28067,Jones County,Mississippi,44140,2689,3433,13930,10246,4686,5519,3637,38018,9156
28069,Kemper County,Mississippi,5930,345,841,1941,1183,639,492,489,4744,981
28071,Lafayette County,Mississippi,32280,820,1836,6962,5239,2871,7803,6749,29624,14552
28073,Lamar County,Mississippi,43319,1431,2384,11266,9285,4397,9135,5421,39504,14556
28075,Lauderdale County,Mississippi,49448,2157,5659,13582,11439,6510,6411,3690,41632,10101
28077,Lawrence County,Mississippi,8086,538,844,3076,1559,945,601,523,6704,1124
28079,Leake County,Mississippi,14465,940,1761,5287,2797,1229,1448,1003,11764,2451
28081,Lee County,Mississippi,55410,2099,4953,14952,11894,5820,10079,5613,48358,15692
28083,Leflore County,Mississippi,17405,1144,1781,5893,3691,1550,1640,1706,14480,3346
28085,Lincoln County,Mississippi,23899,852,2174,9076,4580,2632,2960,1625,20873,4585
28087,Lowndes County,Mississippi,38896,1508,3147,12732,7967,3386,6283,3873,34241,10156
28089,Madison County,Mississippi,73232,1656,3793,12572,13415,5512,20780,15504,67783,36284
28091,Marion County,Mississippi,16676,1201,1671,6273,3503,2149,1043,836,13804,1879
28093,Marshall County,Mississippi,23704,1436,2649,8956,5624,1724,2062,1253,19619,3315
28095,Monroe County,Mississippi,23671,1464,2108,9549,4545,2200,2478,1327,20099,3805
28097,Montgomery County,Mississippi,6714,472,1163,1940,1444,562,606,527,5079,1133
28099,Neshoba County,Mississippi,18167,1000,2213,6088,4213,1871,1356,1426,14954,2782
28101,Newton County,Mississippi,13646,603,1343,4425,2990,2079,1354,852,11700,2206
28103,Noxubee County,Mississippi,6679,466,797,2780,957,787,643,249,5416,892
28105,Oktibbeha County,Mississippi,26082,889,1475,5572,4279,2274,5842,5751,23718,11593
28107,Panola County,Mississippi,22135,1420,2593,7126,4442,3004,2175,1375,18122,3550
28109,Pearl River County,Mississippi,38640,1951,3116,13488,9556,4371,4357,1801,33573,6158
28111,Perry County,Mississippi,7743,431,658,3297,1843,679,528,307,6654,835
28113,Pike County,Mississippi,25894,1200,3278,9031,5245,2806,2468,1866,21416,4334
28115,Pontotoc County,Mississippi,20499,1613,2476,5907,4835,2008,2226,1434,16410,3660
28117,Prentiss County,Mississippi,16541,785,1946,5246,3345,2162,1896,1161,13810,3057
28119,Quitman County,Mississippi,4174,342,693,1298,784,457,425,175,3139,600
28121,Rankin County,Mississippi,108893,3647,7219,25723,24233,12422,22947,12702,98027,35649
28123,Scott County,Mississippi,17818,1932,2048,5659,4848,1356,1279,696,13838,1975
28125,Sharkey County,Mississippi,2511,253,256,998,455,146,283,120,2002,403
28127,Simpson County,Mississippi,17639,1019,2491,5773,3432,2020,2044,860,14129,2904
28129,Smith County,Mississippi,9800,738,1022,3605,2197,819,742,677,8040,1419
28131,Stone County,Mississippi,11853,492,1214,4126,2761,1566,986,708,10147,1694
28133,Sunflower County,Mississippi,17621,1192,2855,5462,3455,1599,1768,1290,13574,3058
28135,Tallahatchie County,Mississippi,8721,629,1278,2996,1677,1123,595,423,6814,1018
28137,Tate County,Mississippi,18279,1163,1844,5981,3913,2077,1762,1539,15272,3301
28139,Tippah County,Mississippi,14263,977,1982,4347,3176,1521,1422,838,11304,2260
28141,Tishomingo County,Mississippi,13416,1188,1296,4335,2859,1753,1091,894,10932,1985
28143,Tunica County,Mississippi,6189,229,784,2544,1021,564,773,274,5176,1047
28145,Union County,Mississippi,18512,1248,2903,5760,3322,2004,2285,990,14361,3275
28147,Walthall County,Mississippi,9323,628,1099,3272,1691,929,1028,676,7596,1704
28149,Warren County,Mississippi,30071,1150,2561,7857,6510,3948,4988,3057,26360,8045
28151,Washington County,Mississippi,29380,2366,3481,9253,5526,2702,3818,2234,23533,6052
28153,Wayne County,Mississippi,12605,965,1247,4643,2385,864,1262,1239,10393,2501
28155,Webster County,Mississippi,6755,259,766,2495,1113,912,727,483,5730,1210
28157,Wilkinson County,Mississippi,6148,192,711,3012,1051,477,448,257,5245,705
28159,Winston County,Mississippi,12329,613,1178,4543,2699,1150,1492,654,10538,2146
28161,Yalobusha County,Mississippi,8961,513,879,4134,1634,695,631,475,7569,1106
28163,Yazoo County,Mississippi,19377,1450,2999,7428,4055,1144,1690,611,14928,2301
29001,Adair County,Missouri,13868,347,763,4466,2475,1061,2132,2624,12758,4756
29003,Andrew County,Missouri,12659,252,448,4900,2767,986,2090,1216,11959,3306
29005,Atchison County,Missouri,3857,117,243,1637,884,154,609,213,3497,822
29007,Audrain County,Missouri,17336,966,1323,7201,3568,1614,1775,889,15047,2664
29009,Barry County,Missouri,24415,1056,2478,10165,4976,2102,2330,1308,20881,3638
29011,Barton County,Missouri,7997,292,777,3328,1453,683,1064,400,6928,1464
29013,Bates County,Missouri,11069,344,928,5372,2102,787,1015,521,9797,1536
29015,Benton County,Missouri,15146,584,1291,6219,3370,1403,1260,1019,13271,2279
29017,Bollinger County,Missouri,7616,284,912,3594,1583,352,539,352,6420,891
29019,Boone County,Missouri,111010,2262,3551,22861,19039,8106,30976,24215,105197,55191
29021,Buchanan County,Missouri,57316,1906,4042,21630,12801,3554,9300,4083,51368,13383
29023,Butler County,Missouri,28995,1292,3465,11743,5985,2479,2563,1468,24238,4031
29025,Caldwell County,Missouri,6078,200,417,2679,1241,519,684,338,5461,1022
29027,Callaway County,Missouri,30868,541,2493,10946,6532,2679,4979,2698,27834,7677
29029,Camden County,Missouri,33043,532,2197,11966,8046,2849,4896,2557,30314,7453
29031,Cape Girardeau County,Missouri,52784,1415,2892,16570,10999,3155,11341,6412,48477,17753
29033,Carroll County,Missouri,5968,135,380,2624,1142,449,796,442,5453,1238
29035,Carter County,Missouri,3586,104,491,1724,521,214,337,195,2991,532
29037,Cass County,Missouri,73862,1543,2823,24117,18655,6146,13604,6974,69496,20578
29039,Cedar County,Missouri,9906,614,792,3970,1938,875,995,722,8500,1717
29041,Chariton County,Missouri,5227,113,301,2301,930,461,714,407,4813,1121
29043,Christian County,Missouri,60588,900,3455,16619,14883,5419,11572,7740,56233,19312
29045,Clark County,Missouri,4607,101,377,2133,885,516,384,211,4129,595
29047,Clay County,Missouri,172370,3437,7249,46295,39711,15441,39614,20623,161684,60237
29049,Clinton County,Missouri,14647,174,733,6395,2922,1151,2320,952,13740,3272
29051,Cole County,Missouri,53377,1267,2727,15777,10301,4198,12288,6819,49383,19107
29053,Cooper County,Missouri,11557,398,705,4489,2194,1073,1809,889,10454,2698
29055,Crawford County,Missouri,16167,912,1640,6237,3588,1593,1500,697,13615,2197
29057,Dade County,Missouri,5543,148,439,2366,1347,445,633,165,4956,798
29059,Dallas County,Missouri,11925,506,819,5836,2572,604,831,757,10600,1588
29061,Daviess County,Missouri,5622,367,360,2286,1071,409,714,415,4895,1129
29063,DeKalb County,Missouri,8719,368,571,3903,1857,746,851,423,7780,1274
29065,Dent County,Missouri,10217,395,1076,4014,2174,791,1110,657,8746,1767
29067,Douglas County,Missouri,8477,290,1002,3381,1982,487,927,408,7185,1335
29069,Dunklin County,Missouri,18633,1290,2431,7925,2758,1688,1346,1195,14912,2541
29071,Franklin County,Missouri,73034,2017,4977,25005,17193,8230,9991,5621,66040,15612
29073,Gasconade County,Missouri,10689,445,739,4172,2303,962,1368,700,9505,2068
29075,Gentry County,Missouri,4199,236,284,1805,684,302,599,289,3679,888
29077,Greene County,Missouri,196608,4467,9038,55513,48095,15810,40170,23515,183103,63685
29079,Grundy County,Missouri,6669,416,555,2572,1357,769,698,302,5698,1000
29081,Harrison County,Missouri,5627,107,413,2580,1027,548,636,316,5107,952
29083,Henry County,Missouri,15702,427,1277,6611,3468,1425,1482,1012,13998,2494
29085,Hickory County,Missouri,6468,189,497,3120,1441,570,488,163,5782,651
29087,Holt County,Missouri,3123,54,145,1407,669,190,416,242,2924,658
29089,Howard County,Missouri,6548,250,501,2289,1272,507,984,745,5797,1729
29091,Howell County,Missouri,27255,914,2848,11100,5492,2002,2909,1990,23493,4899
29093,Iron County,Missouri,6875,404,535,2609,1433,599,793,502,5936,1295
29095,Jackson County,Missouri,487731,13227,27015,138626,110325,37773,100921,59844,447489,160765
29097,Jasper County,Missouri,80808,2887,6585,28248,17484,5611,13785,6208,71336,19993
29099,Jefferson County,Missouri,157831,3298,10617,50800,37353,19838,24161,11764,143916,35925
29101,Johnson County,Missouri,31537,897,1511,10542,6424,3198,5067,3898,29129,8965
29103,Knox County,Missouri,2498,171,199,1087,403,239,244,155,2128,399
29105,Laclede County,Missouri,24359,908,2181,9996,5142,2019,2858,1255,21270,4113
29107,Lafayette County,Missouri,22870,585,1313,9656,4544,1544,3290,1938,20972,5228
29109,Lawrence County,Missouri,25424,1282,2321,10204,6157,1562,2762,1136,21821,3898
29111,Lewis County,Missouri,6369,188,677,2829,1307,414,666,288,5504,954
29113,Lincoln County,Missouri,40408,898,2842,16324,9131,3809,5295,2109,36668,7404
29115,Linn County,Missouri,8178,228,559,3778,1379,630,1042,562,7391,1604
29117,Livingston County,Missouri,10129,373,891,4152,1776,964,1209,764,8865,1973
29119,McDonald County,Missouri,15568,1503,1723,6298,2973,1229,1347,495,12342,1842
29121,Macon County,Missouri,10433,228,684,4712,2063,923,1312,511,9521,1823
29123,Madison County,Missouri,8667,195,824,3832,1620,801,882,513,7648,1395
29125,Maries County,Missouri,6063,356,430,2525,1112,527,701,412,5277,1113
29127,Marion County,Missouri,19366,537,1459,7257,3825,1500,2897,1891,17370,4788
29129,Mercer County,Missouri,2412,54,163,1048,466,187,321,173,2195,494
29131,Miller County,Missouri,17218,373,1497,6687,3580,1447,2543,1091,15348,3634
29133,Mississippi County,Missouri,8660,580,1211,4134,1128,422,814,371,6869,1185
29135,Moniteau County,Missouri,10329,734,674,4422,2035,536,1376,552,8921,1928
29137,Monroe County,Missouri,6104,218,394,3003,1082,407,759,241,5492,1000
29139,Montgomery County,Missouri,8029,297,687,3444,1555,762,847,437,7045,1284
29141,Morgan County,Missouri,14928,1685,1341,5877,2806,1148,1356,715,11902,2071
29143,New Madrid County,Missouri,11194,589,1278,5153,1657,1058,767,692,9327,1459
29145,Newton County,Missouri,40171,1635,2646,14145,9285,3544,5934,2982,35890,8916
29147,Nodaway County,Missouri,12492,224,502,4818,2743,951,1968,1286,11766,3254
29149,Oregon County,Missouri,6160,369,508,2794,1232,376,498,383,5283,881
29151,Osage County,Missouri,9050,268,387,3832,1369,1106,1583,505,8395,2088
29153,Ozark County,Missouri,6552,439,810,2706,1509,408,431,249,5303,680
29155,Pemiscot County,Missouri,10286,761,1068,4950,1732,578,778,419,8457,1197
29157,Perry County,Missouri,13092,711,1169,5356,2177,1022,1879,778,11212,2657
29159,Pettis County,Missouri,28595,1413,2145,9828,6702,3206,3114,2187,25037,5301
29161,Phelps County,Missouri,28068,727,1583,8824,6071,2005,4591,4267,25758,8858
29163,Pike County,Missouri,12388,303,1379,6239,1905,659,1297,606,10706,1903
29165,Platte County,Missouri,73376,731,1933,15927,16584,5685,20222,12294,70712,32516
29167,Polk County,Missouri,20930,884,1647,7827,4818,1512,2672,1570,18399,4242
29169,Pulaski County,Missouri,29480,526,1094,8974,7153,3791,5053,2889,27860,7942
29171,Putnam County,Missouri,3339,113,106,1436,777,292,431,184,3120,615
29173,Ralls County,Missouri,7423,244,388,3625,1430,566,838,332,6791,1170
29175,Randolph County,Missouri,17188,483,1298,7073,3661,1735,2136,802,15407,2938
29177,Ray County,Missouri,16094,449,1215,7265,3611,1119,1717,718,14430,2435
29179,Reynolds County,Missouri,4529,252,711,1722,860,342,515,127,3566,642
29181,Ripley County,Missouri,7522,402,939,2941,1675,673,614,278,6181,892
29183,St. Charles County,Missouri,279408,3620,9129,63757,60523,25122,74037,43220,266659,117257
29185,St. Clair County,Missouri,6828,156,571,2985,1709,563,578,266,6101,844
29186,Ste. Genevieve County,Missouri,13199,353,774,5190,3027,1693,1237,925,12072,2162
29187,St. Francois County,Missouri,47111,1838,4351,17993,11705,3921,4159,3144,40922,7303
29189,St. Louis County,Missouri,693191,12313,27949,144260,135130,54124,181797,137618,652929,319415
29195,Saline County,Missouri,14738,725,1054,5389,2987,900,2492,1191,12959,3683
29197,Schuyler County,Missouri,2678,71,133,1337,434,372,225,106,2474,331
29199,Scotland County,Missouri,2923,375,115,1194,627,185,285,142,2433,427
29201,Scott County,Missouri,25769,1192,2320,9868,5160,1774,3637,1818,22257,5455
29203,Shannon County,Missouri,5131,123,598,2317,871,455,430,337,4410,767
29205,Shelby County,Missouri,4163,119,361,1840,816,296,519,212,3683,731
29207,Stoddard County,Missouri,20128,1213,2520,8652,3390,1357,2068,928,16395,2996
29209,Stone County,Missouri,24357,580,1779,8601,6146,2231,3379,1641,21998,5020
29211,Sullivan County,Missouri,4121,240,347,2012,651,278,379,214,3534,593
29213,Taney County,Missouri,38856,1013,2937,12852,9863,2937,6574,2680,34906,9254
29215,Texas County,Missouri,17662,745,1922,6874,4088,1351,1531,1151,14995,2682
29217,Vernon County,Missouri,13356,525,1029,5284,2707,1439,1454,918,11802,2372
29219,Warren County,Missouri,24681,865,2031,9377,5644,2036,3481,1247,21785,4728
29221,Washington County,Missouri,16328,665,2331,6952,3101,1275,1298,706,13332,2004
29223,Wayne County,Missouri,8244,358,1113,3473,1855,534,572,339,6773,911
29225,Webster County,Missouri,25319,1182,1879,9810,5398,2399,3082,1569,22258,4651
29227,Worth County,Missouri,1400,33,51,743,252,102,150,69,1316,219
29229,Wright County,Missouri,12186,810,1334,5092,2309,1076,978,587,10042,1565
29510,St. Louis city,Missouri,215632,6663,14951,53213,43846,13688,46330,36941,194018,83271
30001,Beaverhead County,Montana,6523,114,258,1773,1349,652,1650,727,6151,2377
30003,Big Horn County,Montana,7432,180,615,2444,1832,888,918,555,6637,1473
30005,Blaine County,Montana,4353,173,301,1161,1080,603,667,368,3879,1035
30007,Broadwater County,Montana,5080,120,219,1393,1346,871,862,269,4741,1131
30009,Carbon County,Montana,8213,149,194,2555,2065,672,1498,1080,7870,2578
30011,Carter County,Montana,994,9,48,308,328,89,174,38,937,212
30013,Cascade County,Montana,57794,1343,2490,18455,13649,5905,10151,5801,53961,15952
30015,Chouteau County,Montana,4079,68,245,1539,827,400,731,269,3766,1000
30017,Custer County,Montana,8580,127,351,2713,2067,1037,1499,786,8102,2285
30019,Daniels County,Montana,1180,11,34,380,301,147,221,86,1135,307
30021,Dawson County,Montana,6222,86,212,1476,1546,1370,1018,514,5924,1532
30023,Deer Lodge County,Montana,7387,228,476,2980,1756,453,1120,374,6683,1494
30025,Fallon County,Montana,1945,25,43,736,421,368,248,104,1877,352
30027,Fergus County,Montana,8568,155,304,2550,2305,891,1897,466,8109,2363
30029,Flathead County,Montana,75750,664,2676,21188,17330,7461,17554,8877,72410,26431
30031,Gallatin County,Montana,77076,483,1384,13737,15435,5275,25951,14811,75209,40762
30033,Garfield County,Montana,687,6,14,250,201,69,104,43,667,147
30035,Glacier County,Montana,8421,391,729,2968,1717,892,1054,670,7301,1724
30037,Golden Valley County,Montana,654,22,35,224,186,34,119,34,597,153
30039,Granite County,Montana,2581,34,214,776,462,283,634,178,2333,812
30041,Hill County,Montana,10008,188,770,3207,2568,908,1731,636,9050,2367
30043,Jefferson County,Montana,8988,260,307,2414,1962,1055,1925,1065,8421,2990
30045,Judith Basin County,Montana,1452,32,52,390,345,237,325,71,1368,396
30047,Lake County,Montana,22064,585,1115,5638,5195,2483,4593,2455,20364,7048
30049,Lewis and Clark County,Montana,50662,574,1944,11577,10015,4912,13856,7784,48144,21640
30051,Liberty County,Montana,1363,200,119,294,288,91,287,84,1044,371
30053,Lincoln County,Montana,15504,286,894,6035,4231,1351,1885,822,14324,2707
30055,McCone County,Montana,1340,12,29,423,438,152,206,80,1299,286
30057,Madison County,Montana,6951,50,201,1977,1620,904,1547,652,6700,2199
30059,Meagher County,Montana,1490,4,37,394,444,71,388,152,1449,540
30061,Mineral County,Montana,3459,78,161,1090,922,307,700,201,3220,901
30063,Missoula County,Montana,81050,1068,1863,16856,18039,7163,22620,13441,78119,36061
30065,Musselshell County,Montana,3692,60,268,1307,938,391,546,182,3364,728
30067,Park County,Montana,13482,81,337,3585,3150,1429,3373,1527,13064,4900
30069,Petroleum County,Montana,323,0,1,141,85,19,55,22,322,77
30071,Phillips County,Montana,3028,47,160,1090,912,212,477,130,2821,607
30073,Pondera County,Montana,4119,281,215,1229,1002,491,727,174,3623,901
30075,Powder River County,Montana,1373,13,134,389,373,114,246,104,1226,350
30077,Powell County,Montana,5489,119,292,2511,1109,394,754,310,5078,1064
30079,Prairie County,Montana,950,40,91,282,209,115,129,84,819,213
30081,Ravalli County,Montana,33694,584,1767,9925,8129,3586,5826,3877,31343,9703
30083,Richland County,Montana,7543,61,262,3180,2104,868,855,213,7220,1068
30085,Roosevelt County,Montana,6182,109,310,2036,1749,752,880,346,5763,1226
30087,Rosebud County,Montana,5134,166,364,1718,1286,602,620,378,4604,998
30089,Sanders County,Montana,9732,267,643,3774,2338,950,1372,388,8822,1760
30091,Sheridan County,Montana,2643,78,174,893,659,165,458,216,2391,674
30093,Silver Bow County,Montana,24314,574,998,8211,5700,2106,4492,2233,22742,6725
30095,Stillwater County,Montana,6538,147,315,2125,1486,551,1348,566,6076,1914
30097,Sweet Grass County,Montana,2593,9,94,832,811,235,453,159,2490,612
30099,Teton County,Montana,4253,226,206,1353,1106,278,770,314,3821,1084
30101,Toole County,Montana,3554,193,256,1370,771,172,460,332,3105,792
30103,Treasure County,Montana,538,4,28,164,120,49,156,17,506,173
30105,Valley County,Montana,5374,56,306,1577,1786,595,899,155,5012,1054
30107,Wheatland County,Montana,1522,59,57,563,391,137,219,96,1406,315
30109,Wibaux County,Montana,773,10,28,343,134,84,132,42,735,174
30111,Yellowstone County,Montana,113507,1532,3800,32439,26898,9949,27169,11720,108175,38889
31001,Adams County,Nebraska,20343,607,936,5531,5045,2721,3383,2120,18800,5503
31003,Antelope County,Nebraska,4288,78,195,1454,941,742,561,317,4015,878
31005,Arthur County,Nebraska,315,2,9,68,85,52,70,29,304,99
31007,Banner County,Nebraska,510,30,15,85,160,65,108,47,465,155
31009,Blaine County,Nebraska,322,2,29,121,56,47,54,13,291,67
31011,Boone County,Nebraska,3747,75,152,1481,786,579,444,230,3520,674
31013,Box Butte County,Nebraska,7434,222,381,2175,2482,831,1117,226,6831,1343
31015,Boyd County,Nebraska,1343,19,45,592,301,159,122,105,1279,227
31017,Brown County,Nebraska,1988,29,121,664,490,260,256,168,1838,424
31019,Buffalo County,Nebraska,31028,805,1506,7637,7224,2945,7178,3733,28717,10911
31021,Burt County,Nebraska,4723,81,343,1617,1004,573,853,252,4299,1105
31023,Butler County,Nebraska,5785,214,227,2018,1039,823,1162,302,5344,1464
31025,Cass County,Nebraska,18457,244,608,5233,4314,2286,3756,2016,17605,5772
31027,Cedar County,Nebraska,5583,98,198,2070,1185,731,941,360,5287,1301
31029,Chase County,Nebraska,2570,148,162,721,658,254,433,194,2260,627
31031,Cherry County,Nebraska,3749,25,57,1266,910,519,693,279,3667,972
31033,Cheyenne County,Nebraska,6642,135,376,2107,1581,860,1107,476,6131,1583
31035,Clay County,Nebraska,4181,100,182,1437,902,658,638,264,3899,902
31037,Colfax County,Nebraska,6596,1135,637,1869,1309,800,649,197,4824,846
31039,Cuming County,Nebraska,6124,225,257,2198,1233,744,1064,403,5642,1467
31041,Custer County,Nebraska,7313,128,261,2339,1666,1032,1394,493,6924,1887
31043,Dakota County,Nebraska,12896,1548,1218,4411,2648,1232,1427,412,10130,1839
31045,Dawes County,Nebraska,5179,54,172,1269,1344,474,937,929,4953,1866
31047,Dawson County,Nebraska,15509,2104,1189,4894,3325,1512,1783,702,12216,2485
31049,Deuel County,Nebraska,1423,90,56,407,386,188,209,87,1277,296
31051,Dixon County,Nebraska,3735,353,231,1229,638,454,622,208,3151,830
31053,Dodge County,Nebraska,24741,1296,1505,8827,5197,2553,3438,1925,21940,5363
31055,Douglas County,Nebraska,381023,17098,15765,79061,81157,30857,99805,57280,348160,157085
31057,Dundy County,Nebraska,1248,19,53,338,375,135,187,141,1176,328
31059,Fillmore County,Nebraska,4136,88,143,1424,900,636,618,327,3905,945
31061,Franklin County,Nebraska,2167,49,101,698,604,299,265,151,2017,416
31063,Frontier County,Nebraska,1692,38,67,448,471,272,292,104,1587,396
31065,Furnas County,Nebraska,3285,117,218,1006,820,421,521,182,2950,703
31067,Gage County,Nebraska,15167,239,898,5740,3200,2056,2234,800,14030,3034
31069,Garden County,Nebraska,1297,13,67,425,326,167,205,94,1217,299
31071,Garfield County,Nebraska,1346,9,49,329,373,157,327,102,1288,429
31073,Gosper County,Nebraska,1445,3,85,411,331,209,292,114,1357,406
31075,Grant County,Nebraska,445,8,29,119,123,46,100,20,408,120
31077,Greeley County,Nebraska,1535,57,53,592,309,261,200,63,1425,263
31079,Hall County,Nebraska,40196,3155,2902,12669,9379,3534,5668,2889,34139,8557
31081,Hamilton County,Nebraska,6405,58,123,1851,1840,935,1048,550,6224,1598
31083,Harlan County,Nebraska,2173,73,86,619,534,328,378,155,2014,533
31085,Hayes County,Nebraska,681,11,37,234,142,134,109,14,633,123
31087,Hitchcock County,Nebraska,1848,27,94,565,614,200,254,94,1727,348
31089,Holt County,Nebraska,6891,152,265,2060,1500,1020,1362,532,6474,1894
31091,Hooker County,Nebraska,420,9,20,145,98,34,109,5,391,114
31093,Howard County,Nebraska,4497,86,100,1722,1072,514,827,176,4311,1003
31095,Jefferson County,Nebraska,5169,137,273,1923,1144,696,773,223,4759,996
31097,Johnson County,Nebraska,3829,144,259,1591,711,396,459,269,3426,728
31099,Kearney County,Nebraska,4456,166,113,1240,1037,524,1089,287,4177,1376
31101,Keith County,Nebraska,6130,266,296,1744,1743,861,855,365,5568,1220
31103,Keya Paha County,Nebraska,633,4,8,204,160,75,140,42,621,182
31105,Kimball County,Nebraska,2506,97,272,921,651,276,211,78,2137,289
31107,Knox County,Nebraska,5741,146,318,2069,1291,831,744,342,5277,1086
31109,Lancaster County,Nebraska,201049,5866,7635,42009,40075,23327,51720,30417,187548,82137
31111,Lincoln County,Nebraska,23882,561,987,7139,6908,3463,3160,1664,22334,4824
31113,Logan County,Nebraska,558,10,4,152,191,60,128,13,544,141
31115,Loup County,Nebraska,461,0,5,167,106,93,61,29,456,90
31117,McPherson County,Nebraska,339,5,16,108,58,93,47,12,318,59
31119,Madison County,Nebraska,23257,950,688,7424,5050,3457,3927,1761,21619,5688
31121,Merrick County,Nebraska,5437,122,265,2004,1455,644,607,340,5050,947
31123,Morrill County,Nebraska,3126,93,238,1061,765,361,434,174,2795,608
31125,Nance County,Nebraska,2370,66,119,800,545,390,289,161,2185,450
31127,Nemaha County,Nebraska,4607,146,304,1353,949,451,966,438,4157,1404
31129,Nuckolls County,Nebraska,3020,36,182,928,693,371,551,259,2802,810
31131,Otoe County,Nebraska,10972,325,450,3541,2446,1396,1941,873,10197,2814
31133,Pawnee County,Nebraska,1794,141,112,719,292,164,228,138,1541,366
31135,Perkins County,Nebraska,1965,99,85,515,557,201,436,72,1781,508
31137,Phelps County,Nebraska,6092,99,368,1647,1593,759,1229,397,5625,1626
31139,Pierce County,Nebraska,4940,132,140,1623,990,965,814,276,4668,1090
31141,Platte County,Nebraska,22403,1148,1164,6649,4835,3101,3926,1580,20091,5506
31143,Polk County,Nebraska,3598,69,215,1295,786,565,487,181,3314,668
31145,Red Willow County,Nebraska,7380,194,377,2272,1829,908,1266,534,6809,1800
31147,Richardson County,Nebraska,5672,95,398,2305,1153,564,870,287,5179,1157
31149,Rock County,Nebraska,925,18,27,321,213,81,211,54,880,265
31151,Saline County,Nebraska,9320,1242,573,2597,1824,1040,1437,607,7505,2044
31153,Sarpy County,Nebraska,123235,1976,3317,25138,28744,13338,32227,18495,117942,50722
31155,Saunders County,Nebraska,15336,251,475,4512,3515,2122,3063,1398,14610,4461
31157,Scotts Bluff County,Nebraska,24201,1131,1500,6759,6219,2496,4153,1943,21570,6096
31159,Seward County,Nebraska,11099,170,477,3111,2261,1644,2472,964,10452,3436
31161,Sheridan County,Nebraska,3595,69,301,1112,957,376,605,175,3225,780
31163,Sherman County,Nebraska,2158,56,141,783,554,217,284,123,1961,407
31165,Sioux County,Nebraska,783,1,30,205,269,83,141,54,752,195
31167,Stanton County,Nebraska,3980,125,114,1224,902,815,565,235,3741,800
31169,Thayer County,Nebraska,3514,77,153,1170,851,472,554,237,3284,791
31171,Thomas County,Nebraska,496,13,29,109,117,106,95,27,454,122
31173,Thurston County,Nebraska,3660,117,258,1244,836,480,515,210,3285,725
31175,Valley County,Nebraska,2868,63,119,898,683,332,569,204,2686,773
31177,Washington County,Nebraska,14264,262,439,3752,3249,1669,3435,1458,13563,4893
31179,Wayne County,Nebraska,5479,125,111,1631,1071,752,1151,638,5243,1789
31181,Webster County,Nebraska,2401,54,92,793,547,399,345,171,2255,516
31183,Wheeler County,Nebraska,611,3,10,186,192,69,109,42,598,151
31185,York County,Nebraska,9553,186,405,2749,2304,1495,1612,802,8962,2414
32001,Churchill County,Nevada,17516,438,930,5914,4971,2173,2169,921,16148,3090
32003,Clark County,Nevada,1560375,90414,120968,434081,372209,130844,271537,140322,1348993,411859
32005,Douglas County,Nevada,38843,870,1698,9459,10517,4129,7930,4240,36275,12170
32007,Elko County,Nevada,34678,1625,2224,11725,9541,3665,3642,2256,30829,5898
32009,Esmeralda County,Nevada,873,35,156,198,227,45,133,79,682,212
32011,Eureka County,Nevada,1111,25,28,467,379,43,108,61,1058,169
32013,Humboldt County,Nevada,11339,627,1027,3868,2458,999,1751,609,9685,2360
32015,Lander County,Nevada,3854,40,336,1334,962,641,255,286,3478,541
32017,Lincoln County,Nevada,3187,94,281,1382,757,184,292,197,2812,489
32019,Lyon County,Nevada,43054,1873,3566,13740,12102,4836,4970,1967,37615,6937
32021,Mineral County,Nevada,3263,73,245,1356,1005,106,414,64,2945,478
32023,Nye County,Nevada,40380,1918,3458,14409,12094,3438,3372,1691,35004,5063
32027,Pershing County,Nevada,5013,144,655,2131,1155,424,291,213,4214,504
32029,Storey County,Nevada,3113,19,217,594,1022,285,526,450,2877,976
32031,Washoe County,Nevada,339174,17065,21944,80269,80688,29051,66824,43333,300165,110157
32033,White Pine County,Nevada,6727,195,524,2851,1516,746,664,231,6008,895
32510,Carson City,Nevada,41987,1680,3123,10745,11618,4616,6883,3322,37184,10205
33001,Belknap County,New Hampshire,47981,700,2461,14242,9711,5540,9127,6200,44820,15327
33003,Carroll County,New Hampshire,39992,613,1376,10749,7956,4284,8647,6367,38003,15014
33005,Cheshire County,New Hampshire,54560,1112,2295,17232,9986,5186,11579,7170,51153,18749
33007,Coos County,New Hampshire,24511,888,1829,9353,4675,2763,3186,1817,21794,5003
33009,Grafton County,New Hampshire,65142,1305,3134,16983,10359,5160,13805,14396,60703,28201
33011,Hillsborough County,New Hampshire,301873,7949,13204,77448,53021,28860,76111,45280,280720,121391
33013,Merrimack County,New Hampshire,110798,2262,4976,32096,18495,12170,23235,17564,103560,40799
33015,Rockingham County,New Hampshire,231996,2725,7052,58104,40032,22981,62863,38239,222219,101102
33017,Strafford County,New Hampshire,87852,1793,3084,22860,15818,10278,21650,12369,82975,34019
33019,Sullivan County,New Hampshire,32648,881,2085,11907,4613,3319,5986,3857,29682,9843
34001,Atlantic County,New Jersey,191583,9134,13123,62259,35387,14049,37957,19674,169326,57631
34003,Bergen County,New Jersey,674596,27266,20003,139534,94755,44593,208030,140415,627327,348445
34005,Burlington County,New Jersey,329081,6380,13090,86939,61633,25868,87020,48151,309611,135171
34007,Camden County,New Jersey,360582,16274,22393,105698,64985,27713,74997,48522,321915,123519
34009,Cape May County,New Jersey,72532,1761,2651,22855,13768,5494,16309,9694,68120,26003
34011,Cumberland County,New Jersey,103984,8292,11252,40756,17477,8167,12061,5979,84440,18040
34013,Essex County,New Jersey,573215,39745,35184,159513,89893,34516,124500,89864,498286,214364
34015,Gloucester County,New Jersey,207727,4497,8793,64728,37385,19264,48158,24902,194437,73060
34017,Hudson County,New Jersey,512195,39042,26689,119319,63892,24467,140539,98247,446464,238786
34019,Hunterdon County,New Jersey,93742,1828,2121,18212,13449,6129,30308,21695,89793,52003
34021,Mercer County,New Jersey,259959,11942,14764,65911,37043,15521,62306,52472,233253,114778
34023,Middlesex County,New Jersey,591318,30351,30654,139214,85291,39040,156153,110615,530313,266768
34025,Monmouth County,New Jersey,454185,10271,15393,97241,70455,34217,138371,88237,428521,226608
34027,Morris County,New Jersey,359811,8235,9490,67636,46900,21951,118638,86961,342086,205599
34029,Ocean County,New Jersey,434506,10850,18927,144538,82839,34219,93595,49538,404729,143133
34031,Passaic County,New Jersey,346430,29445,21903,117258,55277,18318,70286,33943,295082,104229
34033,Salem County,New Jersey,45316,1445,3005,18097,8142,4307,6792,3528,40866,10320
34035,Somerset County,New Jersey,242607,7251,7252,43424,31066,14685,75626,63303,228104,138929
34037,Sussex County,New Jersey,105082,1359,3428,30142,20474,8729,26428,14522,100295,40950
34039,Union County,New Jersey,389288,29781,21594,105850,61146,21804,89290,59823,337913,149113
34041,Warren County,New Jersey,79264,1580,3303,25501,13749,7012,18944,9175,74381,28119
35001,Bernalillo County,New Mexico,469743,17963,28230,106076,102736,42732,93393,78613,423550,172006
35003,Catron County,New Mexico,2925,60,42,1147,975,265,217,219,2823,436
35005,Chaves County,New Mexico,41749,3716,4116,11300,11640,3657,4537,2783,33917,7320
35006,Cibola County,New Mexico,18386,707,2195,6036,4742,1998,1507,1201,15484,2708
35007,Colfax County,New Mexico,9233,183,691,2982,2470,869,1169,869,8359,2038
35009,Curry County,New Mexico,29818,2317,3368,7577,7231,2928,4028,2369,24133,6397
35011,De Baca County,New Mexico,1139,85,90,284,515,60,53,52,964,105
35013,Doña Ana County,New Mexico,134344,13719,11023,30199,27609,10928,23076,17790,109602,40866
35015,Eddy County,New Mexico,39653,2565,3766,11803,10417,3871,4615,2616,33322,7231
35017,Grant County,New Mexico,20381,722,1611,5485,5331,1857,3153,2222,18048,5375
35019,Guadalupe County,New Mexico,3398,351,311,1504,513,243,348,128,2736,476
35021,Harding County,New Mexico,471,17,45,143,69,53,74,70,409,144
35023,Hidalgo County,New Mexico,2908,199,294,1063,634,226,330,162,2415,492
35025,Lea County,New Mexico,43412,5450,4928,14380,8944,3372,3298,3040,33034,6338
35027,Lincoln County,New Mexico,15369,515,1000,4505,4224,1394,2191,1540,13854,3731
35028,Los Alamos County,New Mexico,13886,139,149,1418,1866,640,3869,5805,13598,9674
35029,Luna County,New Mexico,16460,1925,2488,5871,3187,1036,1129,824,12047,1953
35031,McKinley County,New Mexico,45143,3202,5491,16149,11191,3496,3341,2273,36450,5614
35033,Mora County,New Mexico,3394,131,94,1341,935,194,258,441,3169,699
35035,Otero County,New Mexico,44772,2462,3557,12906,11805,4646,6168,3228,38753,9396
35037,Quay County,New Mexico,6380,157,724,2426,1554,496,637,386,5499,1023
35039,Rio Arriba County,New Mexico,27682,1536,2543,9067,7419,2069,2941,2107,23603,5048
35041,Roosevelt County,New Mexico,11171,743,851,3628,2966,704,1453,826,9577,2279
35043,Sandoval County,New Mexico,103937,2758,5695,25905,24966,11206,20227,13180,95484,33407
35045,San Juan County,New Mexico,79736,2979,8530,23378,22394,9902,7345,5208,68227,12553
35047,San Miguel County,New Mexico,19765,1308,1960,4922,5177,1697,2768,1933,16497,4701
35049,Santa Fe County,New Mexico,116573,5159,5739,24454,23336,8726,24664,24495,105675,49159
35051,Sierra County,New Mexico,9168,282,603,3318,2229,926,1075,735,8283,1810
35053,Socorro County,New Mexico,10697,869,764,4654,1909,708,680,1113,9064,1793
35055,Taos County,New Mexico,26461,425,1320,6974,6528,2094,5014,4106,24716,9120
35057,Torrance County,New Mexico,10624,529,958,3864,3038,692,958,585,9137,1543
35059,Union County,New Mexico,2860,91,265,1228,662,170,278,166,2504,444
35061,Valencia County,New Mexico,52270,2828,5126,16080,12381,4830,5911,5114,44316,11025
36001,Albany County,New York,211845,6152,9531,45925,31975,24169,47712,46381,196162,94093
36003,Allegany County,New York,29967,1049,1543,10197,5518,4317,3833,3510,27375,7343
36005,Bronx County,New York,943981,118954,121541,266547,160924,75747,127270,72998,703486,200268
36007,Broome County,New York,131196,3877,8476,39366,23132,17206,20751,18388,118843,39139
36009,Cattaraugus County,New York,53128,2259,3448,21333,8922,6434,5788,4944,47421,10732
36011,Cayuga County,New York,55374,1878,4495,17825,10250,8203,7335,5388,49001,12723
36013,Chautauqua County,New York,89404,3331,5897,30111,15693,12656,12068,9648,80176,21716
36015,Chemung County,New York,58945,1527,4265,20027,10850,7800,7943,6533,53153,14476
36017,Chenango County,New York,33959,1006,2891,13772,6066,4020,3325,2879,30062,6204
36019,Clinton County,New York,55243,1898,4789,18175,8966,6402,8494,6519,48556,15013
36021,Columbia County,New York,47307,1292,2472,13845,6506,5976,8970,8246,43543,17216
36023,Cortland County,New York,29274,1003,1739,8983,5744,3655,4387,3763,26532,8150
36025,Delaware County,New York,33158,868,2327,12621,5142,3912,4409,3879,29963,8288
36027,Dutchess County,New York,210886,6174,11637,54195,35344,21329,43496,38711,193075,82207
36029,Erie County,New York,671368,20057,32374,175067,119675,79925,135561,108709,618937,244270
36031,Essex County,New York,28930,624,1794,9477,4500,3515,5079,3941,26512,9020
36033,Franklin County,New York,33832,1392,3020,11855,5649,4423,4152,3341,29420,7493
36035,Fulton County,New York,38665,1411,3427,13989,6492,5873,4454,3019,33827,7473
36037,Genesee County,New York,41797,1144,1996,15487,7261,6226,5638,4045,38657,9683
36039,Greene County,New York,36429,1454,2742,12729,5460,3994,5892,4158,32233,10050
36041,Hamilton County,New York,4107,105,477,1223,658,685,548,411,3525,959
36043,Herkimer County,New York,43013,1258,2467,14760,7953,6956,5719,3900,39288,9619
36045,Jefferson County,New York,74585,2024,4261,24012,16042,9437,11185,7624,68300,18809
36047,Kings County,New York,1860601,156609,145204,461059,230189,115816,448448,303276,1558788,751724
36049,Lewis County,New York,18480,487,1140,8025,2770,2508,1987,1563,16853,3550
36051,Livingston County,New York,41890,1049,2193,13125,7470,5711,6471,5871,38648,12342
36053,Madison County,New York,46161,908,2292,15878,7703,6973,6623,5784,42961,12407
36055,Monroe County,New York,525640,16840,28555,120254,84165,63012,116878,95936,480245,212814
36057,Montgomery County,New York,34309,1414,2435,12241,6569,4865,3799,2986,30460,6785
36059,Nassau County,New York,969981,43689,35739,208039,139906,74855,254707,213046,890553,467753
36061,New York County,New York,1267630,78259,67972,155808,124936,45211,410095,385349,1121399,795444
36063,Niagara County,New York,152567,3627,9049,48564,28359,21731,24288,16949,139891,41237
36065,Oneida County,New York,159897,7580,10187,48571,29302,20580,24775,18902,142130,43677
36067,Onondaga County,New York,324436,9113,18904,81435,55024,40107,65547,54306,296419,119853
36069,Ontario County,New York,80008,2105,3224,20389,13645,10851,15907,13887,74679,29794
36071,Orange County,New York,256375,9698,16741,72968,49048,27005,46559,34356,229936,80915
36073,Orleans County,New York,29333,1205,2859,11382,5320,3346,3434,1787,25269,5221
36075,Oswego County,New York,80294,2091,6116,29738,14653,10487,10192,7017,72087,17209
36077,Otsego County,New York,39352,781,2126,12301,6412,4472,7088,6172,36445,13260
36079,Putnam County,New York,70716,2135,2634,17775,12006,5881,17119,13166,65947,30285
36081,Queens County,New York,1709759,174351,119876,444621,243390,133058,365140,229323,1415532,594463
36083,Rensselaer County,New York,113385,3046,5549,30257,18942,15497,23380,16714,104790,40094
36085,Richmond County,New York,344639,17969,21062,102409,56010,25414,72848,48927,305608,121775
36087,Rockland County,New York,208539,10878,12870,46050,34350,15838,49010,39543,184791,88553
36089,St. Lawrence County,New York,71483,3219,4787,25397,12202,9094,8590,8194,63477,16784
36091,Saratoga County,New York,170815,3231,7032,41434,25941,19033,41136,33008,160552,74144
36093,Schenectady County,New York,109680,3440,5728,29282,19792,13882,20727,16829,100512,37556
36095,Schoharie County,New York,21509,528,1378,7419,4143,2672,2907,2462,19603,5369
36097,Schuyler County,New York,13283,334,740,4710,2634,1613,1674,1578,12209,3252
36099,Seneca County,New York,24400,1301,2556,7942,3846,3351,3301,2103,20543,5404
36101,Steuben County,New York,66493,2012,3664,23211,11045,9371,8548,8642,60817,17190
36103,Suffolk County,New York,1067104,53658,48095,270931,175763,102205,225180,191272,965351,416452
36105,Sullivan County,New York,55556,3032,4379,17242,9800,5676,9021,6406,48145,15427
36107,Tioga County,New York,34747,742,2028,12415,5589,4829,5426,3718,31977,9144
36109,Tompkins County,New York,61156,1046,1598,10421,7685,5249,15045,20112,58512,35157
36111,Ulster County,New York,134090,3403,8038,37960,23551,13419,26089,21630,122649,47719
36113,Warren County,New York,49282,1202,2907,14013,8510,5972,8787,7891,45173,16678
36115,Washington County,New York,45270,1808,3125,17598,8161,5013,5655,3910,40337,9565
36117,Wayne County,New York,65234,2389,3764,20634,13319,8820,10056,6252,59081,16308
36119,Westchester County,New York,695064,38013,36378,124239,90107,46563,177680,182084,620673,359764
36121,Wyoming County,New York,29511,971,2728,11178,5137,4119,3251,2127,25812,5378
36123,Yates County,New York,16746,1928,698,5956,2482,1657,2386,1639,14120,4025
37001,Alamance County,North Carolina,115744,5469,8069,32280,25583,12705,21972,9666,102206,31638
37003,Alexander County,North Carolina,26366,1160,2535,10685,4991,2955,2910,1130,22671,4040
37005,Alleghany County,North Carolina,8508,383,1123,2557,1914,766,1143,622,7002,1765
37007,Anson County,North Carolina,15790,725,2040,6931,2825,1471,1380,418,13025,1798
37009,Ashe County,North Carolina,20539,676,1992,6183,4724,2694,2588,1682,17871,4270
37011,Avery County,North Carolina,13603,657,1120,4216,3345,1231,1852,1182,11826,3034
37013,Beaufort County,North Carolina,32694,1723,2594,10295,7812,3905,3996,2369,28377,6365
37015,Bertie County,North Carolina,13425,621,1992,4867,2698,1018,1459,770,10812,2229
37017,Bladen County,North Carolina,21347,740,1785,7228,5078,2193,2992,1331,18822,4323
37019,Brunswick County,North Carolina,111828,2018,5209,29969,25095,13308,22776,13453,104601,36229
37021,Buncombe County,North Carolina,200084,5992,9764,46355,34326,17543,51168,34936,184328,86104
37023,Burke County,North Carolina,64552,3913,5913,20923,13266,7780,7983,4774,54726,12757
37025,Cabarrus County,North Carolina,150268,4150,7944,38999,29845,14502,36005,18823,138174,54828
37027,Caldwell County,North Carolina,58269,3500,7069,18541,13017,6095,7183,2864,47700,10047
37029,Camden County,North Carolina,7290,251,313,2209,1793,949,1194,581,6726,1775
37031,Carteret County,North Carolina,52162,980,3130,12317,13077,6033,10353,6272,48052,16625
37033,Caswell County,North Carolina,16679,781,1938,6192,3311,1884,1645,928,13960,2573
37035,Catawba County,North Carolina,112106,4742,9397,33604,22643,13918,19436,8366,97967,27802
37037,Chatham County,North Carolina,56742,2644,3360,10332,8982,5030,14026,12368,50738,26394
37039,Cherokee County,North Carolina,22423,608,1376,7401,4908,2832,3511,1787,20439,5298
37041,Chowan County,North Carolina,10603,445,973,3567,2113,939,1606,960,9185,2566
37043,Clay County,North Carolina,8551,298,699,2082,1890,1118,1503,961,7554,2464
37045,Cleveland County,North Carolina,68628,2921,6146,23802,13396,9057,8415,4891,59561,13306
37047,Columbus County,North Carolina,35890,1771,3390,13458,8174,3881,3483,1733,30729,5216
37049,Craven County,North Carolina,68006,2071,4131,18206,18167,7983,10281,7167,61804,17448
37051,Cumberland County,North Carolina,208267,4646,11360,55280,57607,23370,36206,19798,192261,56004
37053,Currituck County,North Carolina,20448,431,1034,6661,4849,1940,3797,1736,18983,5533
37055,Dare County,North Carolina,27944,366,1054,5942,6142,2553,7818,4069,26524,11887
37057,Davidson County,North Carolina,119381,4796,11265,38994,27267,12619,17220,7220,103320,24440
37059,Davie County,North Carolina,30752,934,2191,9363,7248,2965,5358,2693,27627,8051
37061,Duplin County,North Carolina,33381,2841,3725,10530,7492,3493,3796,1504,26815,5300
37063,Durham County,North Carolina,225746,11021,9999,38897,32269,16432,61099,56029,204726,117128
37065,Edgecombe County,North Carolina,34110,1673,3244,12963,7398,2778,4421,1633,29193,6054
37067,Forsyth County,North Carolina,257771,10955,16832,64070,52129,22768,55140,35877,229984,91017
37069,Franklin County,North Carolina,48583,2699,3654,14285,11198,5230,7856,3661,42230,11517
37071,Gaston County,North Carolina,158986,5995,13662,46809,34951,17828,27972,11769,139329,39741
37073,Gates County,North Carolina,7757,249,489,3370,2196,763,408,282,7019,690
37075,Graham County,North Carolina,5809,247,677,2068,1329,685,588,215,4885,803
37077,Granville County,North Carolina,43383,2578,3570,13311,9281,4379,7032,3232,37235,10264
37079,Greene County,North Carolina,14601,1512,1982,4925,2787,1722,1176,497,11107,1673
37081,Guilford County,North Carolina,357540,13909,21498,81118,72916,32509,85562,50028,322133,135590
37083,Halifax County,North Carolina,34748,2127,4434,12764,6878,3078,3483,1984,28187,5467
37085,Harnett County,North Carolina,88532,3981,6445,25715,20888,11354,13404,6745,78106,20149
37087,Haywood County,North Carolina,46815,1508,2974,12646,10434,5796,8218,5239,42333,13457
37089,Henderson County,North Carolina,87179,2962,4388,21950,18940,9336,18490,11113,79829,29603
37091,Hertford County,North Carolina,15136,706,1732,5303,3411,1559,1430,995,12698,2425
37093,Hoke County,North Carolina,33996,1514,2260,9495,8925,4942,4660,2200,30222,6860
37095,Hyde County,North Carolina,3706,174,529,1405,641,429,425,103,3003,528
37097,Iredell County,North Carolina,130349,4051,7863,34473,27940,13398,29342,13282,118435,42624
37099,Jackson County,North Carolina,27605,1069,1882,7850,5451,3120,4787,3446,24654,8233
37101,Johnston County,North Carolina,146407,6568,8762,40542,32406,19727,27955,10447,131077,38402
37103,Jones County,North Carolina,6848,300,674,2519,1591,686,811,267,5874,1078
37105,Lee County,North Carolina,43222,2696,3724,11615,10390,5715,6339,2743,36802,9082
37107,Lenoir County,North Carolina,38258,2056,4808,12737,7946,4968,3974,1769,31394,5743
37109,Lincoln County,North Carolina,63079,2097,4327,19029,13845,7342,11737,4702,56655,16439
37111,McDowell County,North Carolina,32612,1332,3181,11223,6811,4207,4060,1798,28099,5858
37113,Macon County,North Carolina,27929,1148,1790,8910,6425,2825,4474,2357,24991,6831
37115,Madison County,North Carolina,15610,549,1178,4840,2980,1034,3298,1731,13883,5029
37117,Martin County,North Carolina,16019,934,1953,4868,3793,1993,1790,688,13132,2478
37119,Mecklenburg County,North Carolina,755037,35376,33409,123666,140147,61670,234207,126562,686252,360769
37121,Mitchell County,North Carolina,11148,412,723,3321,3006,1229,1536,921,10013,2457
37123,Montgomery County,North Carolina,18303,888,2055,6208,3498,2042,2417,1195,15360,3612
37125,Moore County,North Carolina,72283,2031,3158,15010,14427,8841,17050,11766,67094,28816
37127,Nash County,North Carolina,66173,2755,6140,21559,13387,7808,10109,4415,57278,14524
37129,New Hanover County,North Carolina,158599,3739,6516,30323,31997,17186,44834,24004,148344,68838
37131,Northampton County,North Carolina,13261,759,1429,4511,2715,1491,1430,926,11073,2356
37133,Onslow County,North Carolina,110214,2576,6224,32713,28748,11673,19410,8870,101414,28280
37135,Orange County,North Carolina,92484,2754,3333,11700,10977,6644,25510,31566,86397,57076
37137,Pamlico County,North Carolina,9769,316,657,3083,2383,940,1214,1176,8796,2390
37139,Pasquotank County,North Carolina,27830,896,1971,7932,7021,2753,4783,2474,24963,7257
37141,Pender County,North Carolina,43541,1365,2891,12222,9896,4708,8374,4085,39285,12459
37143,Perquimans County,North Carolina,9828,376,962,3173,2527,865,1072,853,8490,1925
37145,Person County,North Carolina,27970,1015,2220,9860,6578,3396,3539,1362,24735,4901
37147,Pitt County,North Carolina,105366,3803,6518,25938,20723,13468,21025,13891,95045,34916
37149,Polk County,North Carolina,15320,334,775,4073,3317,1714,3285,1822,14211,5107
37151,Randolph County,North Carolina,100308,5812,10254,35215,22102,10113,11923,4889,84242,16812
37153,Richmond County,North Carolina,29335,1668,3405,9096,6571,3539,3131,1925,24262,5056
37155,Robeson County,North Carolina,75885,5124,11305,25610,15004,7750,7243,3849,59456,11092
37157,Rockingham County,North Carolina,66036,3327,7478,23110,14960,6963,6974,3224,55231,10198
37159,Rowan County,North Carolina,101628,4352,8430,33704,22859,11368,14877,6038,88846,20915
37161,Rutherford County,North Carolina,46748,2110,4472,14465,11101,5355,6080,3165,40166,9245
37163,Sampson County,North Carolina,39775,2785,4126,14320,8235,4382,4136,1791,32864,5927
37165,Scotland County,North Carolina,23188,771,3347,8161,5144,2409,2115,1241,19070,3356
37167,Stanly County,North Carolina,44097,1942,4238,14474,9713,5465,5840,2425,37917,8265
37169,Stokes County,North Carolina,32996,1364,2766,12618,7435,3494,3471,1848,28866,5319
37171,Surry County,North Carolina,50638,3525,5578,14773,11567,5973,6190,3032,41535,9222
37173,Swain County,North Carolina,9664,433,1005,3148,2042,995,1207,834,8226,2041
37175,Transylvania County,North Carolina,25529,467,1124,6117,5905,2452,6065,3399,23938,9464
37177,Tyrrell County,North Carolina,2542,112,464,955,521,179,198,113,1966,311
37179,Union County,North Carolina,154639,6069,8703,35354,31134,13923,39363,20093,139867,59456
37181,Vance County,North Carolina,28800,1450,2966,10147,6577,2532,3502,1626,24384,5128
37183,Wake County,North Carolina,764919,20856,25258,111859,119374,61867,258183,167522,718805,425705
37185,Warren County,North Carolina,14047,545,1499,5588,2619,1361,1606,829,12003,2435
37187,Washington County,North Carolina,7927,582,547,2664,2121,895,848,270,6798,1118
37189,Watauga County,North Carolina,31195,895,1451,6717,5938,2305,7527,6362,28849,13889
37191,Wayne County,North Carolina,78268,4752,6406,23240,18484,9740,10860,4786,67110,15646
37193,Wilkes County,North Carolina,47754,2818,6026,15621,10083,5382,5550,2274,38910,7824
37195,Wilson County,North Carolina,54088,3672,5299,18115,10533,5400,7053,4016,45117,11069
37197,Yadkin County,North Carolina,26525,1291,2300,9599,6164,3427,2841,903,22934,3744
37199,Yancey County,North Carolina,13849,573,1016,4775,2860,1527,1988,1110,12260,3098
38001,Adams County,North Dakota,1576,33,72,582,394,173,209,113,1471,322
38003,Barnes County,North Dakota,7518,148,231,2343,1528,1110,1624,534,7139,2158
38005,Benson County,North Dakota,3366,88,343,1018,641,581,495,200,2935,695
38007,Billings County,North Dakota,608,9,20,216,79,108,121,55,579,176
38009,Bottineau County,North Dakota,4468,77,249,1363,1002,600,881,296,4142,1177
38011,Bowman County,North Dakota,2027,45,177,677,393,293,305,137,1805,442
38013,Burke County,North Dakota,1545,34,91,409,413,216,317,65,1420,382
38015,Burleigh County,North Dakota,66365,1431,1933,15409,12334,10523,17514,7221,63001,24735
38017,Cass County,North Dakota,117253,2237,2871,22196,24256,15725,34136,15832,112145,49968
38019,Cavalier County,North Dakota,2643,85,93,685,739,418,540,83,2465,623
38021,Dickey County,North Dakota,3194,125,149,853,617,597,666,187,2920,853
38023,Divide County,North Dakota,1547,66,82,356,426,287,232,98,1399,330
38025,Dunn County,North Dakota,2918,155,120,1002,636,451,430,124,2643,554
38027,Eddy County,North Dakota,1710,61,75,512,381,221,341,119,1574,460
38029,Emmons County,North Dakota,2454,156,102,859,570,323,322,122,2196,444
38031,Foster County,North Dakota,2448,55,84,728,576,457,459,89,2309,548
38033,Golden Valley County,North Dakota,1278,24,44,288,404,217,207,94,1210,301
38035,Grand Forks County,North Dakota,43156,643,1256,9583,9804,6025,10451,5394,41257,15845
38037,Grant County,North Dakota,1733,86,56,567,412,247,308,57,1591,365
38039,Griggs County,North Dakota,1688,91,58,543,369,176,319,132,1539,451
38041,Hettinger County,North Dakota,1839,112,108,615,489,189,236,90,1619,326
38043,Kidder County,North Dakota,1664,58,109,548,368,270,257,54,1497,311
38045,LaMoure County,North Dakota,2956,170,121,861,743,312,603,146,2665,749
38047,Logan County,North Dakota,1360,82,37,379,277,254,266,65,1241,331
38049,McHenry County,North Dakota,3755,147,208,1243,854,575,589,139,3400,728
38051,McIntosh County,North Dakota,1969,167,78,689,322,384,244,85,1724,329
38053,McKenzie County,North Dakota,8610,139,488,2413,2120,1329,1662,459,7983,2121
38055,McLean County,North Dakota,7093,217,264,2283,1519,1232,1294,284,6612,1578
38057,Mercer County,North Dakota,5913,262,357,1484,1492,1140,894,284,5294,1178
38059,Morton County,North Dakota,22764,721,747,6533,5524,3154,4788,1297,21296,6085
38061,Mountrail County,North Dakota,6150,229,454,1954,1402,717,927,467,5467,1394
38063,Nelson County,North Dakota,2207,54,78,610,506,328,469,162,2075,631
38065,Oliver County,North Dakota,1285,26,43,397,397,144,206,72,1216,278
38067,Pembina County,North Dakota,4956,175,215,1623,1163,695,838,247,4566,1085
38069,Pierce County,North Dakota,2855,65,130,844,595,382,574,265,2660,839
38071,Ramsey County,North Dakota,7912,169,407,2122,1771,1428,1499,516,7336,2015
38073,Ransom County,North Dakota,3927,151,207,1396,806,535,622,210,3569,832
38075,Renville County,North Dakota,1520,77,57,478,390,172,270,76,1386,346
38077,Richland County,North Dakota,10689,240,454,2628,2540,2264,2030,533,9995,2563
38079,Rolette County,North Dakota,7156,268,777,1986,1763,1200,789,373,6111,1162
38081,Sargent County,North Dakota,2755,47,112,966,643,479,388,120,2596,508
38083,Sheridan County,North Dakota,1054,31,70,421,254,127,143,8,953,151
38085,Sioux County,North Dakota,2058,71,220,745,503,283,180,56,1767,236
38087,Slope County,North Dakota,645,11,43,225,111,108,124,23,591,147
38089,Stark County,North Dakota,21339,639,1082,6721,4833,2681,4023,1360,19618,5383
38091,Steele County,North Dakota,1274,13,36,308,398,137,339,43,1225,382
38093,Stutsman County,North Dakota,15007,493,748,5477,3132,1484,2706,967,13766,3673
38095,Towner County,North Dakota,1565,102,127,441,361,267,216,51,1336,267
38097,Traill County,North Dakota,5433,171,169,1406,1167,856,1198,466,5093,1664
38099,Walsh County,North Dakota,7374,509,458,2617,1430,1040,920,400,6407,1320
38101,Ward County,North Dakota,44411,1272,1367,12796,10475,5444,9023,4034,41772,13057
38103,Wells County,North Dakota,2869,136,118,1081,620,295,527,92,2615,619
38105,Williams County,North Dakota,24397,564,1675,7658,4878,3645,4410,1567,22158,5977
39001,Adams County,Ohio,18788,755,2068,8367,2931,1807,1514,1346,15965,2860
39003,Allen County,Ohio,68467,1325,4164,27540,14590,7740,8167,4941,62978,13108
39005,Ashland County,Ohio,35796,977,2642,15311,6000,3026,5103,2737,32177,7840
39007,Ashtabula County,Ohio,68664,2873,6322,28924,13804,5976,7102,3663,59469,10765
39009,Athens County,Ohio,36121,616,2370,11396,6308,3052,5632,6747,33135,12379
39011,Auglaize County,Ohio,31516,478,1596,13297,5798,3819,3973,2555,29442,6528
39013,Belmont County,Ohio,48858,931,3233,22527,8016,5635,5451,3065,44694,8516
39015,Brown County,Ohio,30495,867,2952,13789,5705,2747,2893,1542,26676,4435
39017,Butler County,Ohio,250309,7338,14662,81336,47442,19672,51348,28511,228309,79859
39019,Carroll County,Ohio,19215,919,1221,9058,3351,2081,1623,962,17075,2585
39021,Champaign County,Ohio,27213,554,1794,11414,6050,2463,3345,1593,24865,4938
39023,Clark County,Ohio,93613,2267,8031,34933,21175,9751,10887,6569,83315,17456
39025,Clermont County,Ohio,145158,3245,9167,47203,28322,13388,27683,16150,132746,43833
39027,Clinton County,Ohio,28281,655,1855,11139,5813,2991,3621,2207,25771,5828
39029,Columbiana County,Ohio,73589,1995,5476,33094,13175,7720,8083,4046,66118,12129
39031,Coshocton County,Ohio,25230,1860,2040,10812,3973,2381,2712,1452,21330,4164
39033,Crawford County,Ohio,29418,835,2134,13565,5515,3025,2754,1590,26449,4344
39035,Cuyahoga County,Ohio,889511,24259,56631,241494,181763,72472,180290,132602,808621,312892
39037,Darke County,Ohio,35316,698,2457,16078,7370,2958,3844,1911,32161,5755
39039,Defiance County,Ohio,26294,633,1474,10634,5746,2832,3177,1798,24187,4975
39041,Delaware County,Ohio,143354,1211,2855,23641,23722,9582,49877,32466,139288,82343
39043,Erie County,Ohio,54257,952,3467,18460,11867,5151,9429,4931,49838,14360
39045,Fairfield County,Ohio,107962,1676,4932,35396,22897,9496,22057,11508,101354,33565
39047,Fayette County,Ohio,19802,645,2326,9315,3239,1557,1702,1018,16831,2720
39049,Franklin County,Ohio,884031,27757,47311,212318,166537,61574,226726,141808,808963,368534
39051,Fulton County,Ohio,29212,370,1424,12577,6040,3462,3401,1938,27418,5339
39053,Gallia County,Ohio,19986,933,1805,8129,3395,2092,2062,1570,17248,3632
39055,Geauga County,Ohio,66126,4001,1900,16929,12443,4832,16495,9526,60225,26021
39057,Greene County,Ohio,113708,1772,4820,25669,23858,10747,24036,22806,107116,46842
39059,Guernsey County,Ohio,26855,1191,2503,11448,4982,2721,2603,1407,23161,4010
39061,Hamilton County,Ohio,560476,13143,30891,143695,100976,45811,135727,90233,516442,225960
39063,Hancock County,Ohio,51383,611,2558,18597,10339,4636,9236,5406,48214,14642
39065,Hardin County,Ohio,18602,624,940,8791,3337,1472,2148,1290,17038,3438
39067,Harrison County,Ohio,10528,419,825,5117,1641,1296,792,438,9284,1230
39069,Henry County,Ohio,19085,464,873,8180,3755,2351,2369,1093,17748,3462
39071,Highland County,Ohio,29583,1414,3016,12348,4975,3338,2916,1576,25153,4492
39073,Hocking County,Ohio,19886,866,1541,8402,3917,2227,2113,820,17479,2933
39075,Holmes County,Ohio,26321,9371,1794,8510,2689,1046,1941,970,15156,2911
39077,Huron County,Ohio,39929,1282,2638,18175,7776,3855,4155,2048,36009,6203
39079,Jackson County,Ohio,22338,1130,1762,10255,3428,2216,2415,1132,19446,3547
39081,Jefferson County,Ohio,46261,963,2463,20080,8123,5611,5738,3283,42835,9021
39083,Knox County,Ohio,41172,1560,1939,15883,8467,3561,6265,3497,37673,9762
39085,Lake County,Ohio,168448,2883,7879,53371,37680,16223,33187,17225,157686,50412
39087,Lawrence County,Ohio,40878,1321,3008,17716,7752,3660,4544,2877,36549,7421
39089,Licking County,Ohio,121399,1938,6367,40864,24576,11782,24104,11768,113094,35872
39091,Logan County,Ohio,32033,382,1861,13889,6302,3559,3956,2084,29790,6040
39093,Lorain County,Ohio,218104,4618,14563,68487,48633,22439,37312,22052,198923,59364
39095,Lucas County,Ohio,291940,7243,19461,87399,65909,30299,51164,30465,265236,81629
39097,Madison County,Ohio,31763,725,2823,12473,6724,2541,4439,2038,28215,6477
39099,Mahoning County,Ohio,162714,4066,9862,59181,33385,13633,27175,15412,148786,42587
39101,Marion County,Ohio,46136,1260,3599,20231,10797,4037,4186,2026,41277,6212
39103,Medina County,Ohio,128630,1844,4539,38033,25935,12090,30285,15904,122247,46189
39105,Meigs County,Ohio,15814,654,1596,7210,2637,1901,1270,546,13564,1816
39107,Mercer County,Ohio,28029,322,1636,12350,4451,3562,3839,1869,26071,5708
39109,Miami County,Ohio,75367,1140,4266,27978,15822,7569,11540,7052,69961,18592
39111,Monroe County,Ohio,9678,298,783,4796,1584,1180,686,351,8597,1037
39113,Montgomery County,Ohio,368011,8482,22046,102472,87332,37386,65792,44501,337483,110293
39115,Morgan County,Ohio,9961,298,1043,4451,1878,1177,735,379,8620,1114
39117,Morrow County,Ohio,24585,1004,1516,11143,4816,1952,2890,1264,22065,4154
39119,Muskingum County,Ohio,59133,1679,3996,25209,10714,6097,7036,4402,53458,11438
39121,Noble County,Ohio,10794,393,1255,5494,1410,826,930,486,9146,1416
39123,Ottawa County,Ohio,30571,415,1694,10867,6415,2959,5257,2964,28462,8221
39125,Paulding County,Ohio,13005,302,1012,5809,2553,1325,1410,594,11691,2004
39127,Perry County,Ohio,24430,465,2469,11140,4305,2435,2499,1117,21496,3616
39129,Pickaway County,Ohio,40969,1002,4034,16686,7908,3302,5568,2469,35933,8037
39131,Pike County,Ohio,18624,706,2245,8853,2699,1519,1754,848,15673,2602
39133,Portage County,Ohio,106257,1997,5581,38280,18617,8060,19883,13839,98679,33722
39135,Preble County,Ohio,28742,476,1835,12806,5755,2458,3334,2078,26431,5412
39137,Putnam County,Ohio,22965,408,783,8706,3772,3344,4044,1908,21774,5952
39139,Richland County,Ohio,87245,2618,6494,36479,18079,8087,9600,5888,78133,15488
39141,Ross County,Ohio,54657,1625,4554,24800,10746,3897,5498,3537,48478,9035
39143,Sandusky County,Ohio,41566,715,2127,17626,8570,4911,5219,2398,38724,7617
39145,Scioto County,Ohio,51355,1701,4689,22278,9780,3888,5493,3526,44965,9019
39147,Seneca County,Ohio,37084,468,1981,16128,7322,4192,4528,2465,34635,6993
39149,Shelby County,Ohio,31994,545,2276,13163,5706,3696,4261,2347,29173,6608
39151,Stark County,Ohio,262027,5461,13669,99440,56099,24242,40551,22565,242897,63116
39153,Summit County,Ohio,381738,9117,19382,111042,78564,31640,83276,48717,353239,131993
39155,Trumbull County,Ohio,144381,4760,10288,61991,27152,11287,19107,9796,129333,28903
39157,Tuscarawas County,Ohio,64183,3101,4111,28763,10336,5246,8450,4176,56971,12626
39159,Union County,Ohio,43037,424,1758,13144,7865,2924,11101,5821,40855,16922
39161,Van Wert County,Ohio,19896,295,1161,8794,3900,2323,2095,1328,18440,3423
39163,Vinton County,Ohio,9053,350,1437,3762,1342,764,966,432,7266,1398
39165,Warren County,Ohio,164904,2653,5873,41030,28024,13676,44054,29594,156378,73648
39167,Washington County,Ohio,42689,712,2807,16188,8791,5448,5482,3261,39170,8743
39169,Wayne County,Ohio,76670,6291,4082,29973,12491,5406,11090,7337,66297,18427
39171,Williams County,Ohio,25795,366,1941,11133,5782,2856,2366,1351,23488,3717
39173,Wood County,Ohio,82400,1311,2958,23291,16093,7841,18369,12537,78131,30906
39175,Wyandot County,Ohio,15341,277,646,7112,2486,1570,2033,1217,14418,3250
40001,Adair County,Oklahoma,12785,618,1715,5958,2465,641,846,542,10452,1388
40003,Alfalfa County,Oklahoma,4251,157,377,1581,936,319,602,279,3717,881
40005,Atoka County,Oklahoma,10044,364,1373,4096,2049,678,983,501,8307,1484
40007,Beaver County,Oklahoma,3387,279,213,1050,754,323,565,203,2895,768
40009,Beckham County,Oklahoma,15297,595,1734,6048,3352,1248,1574,746,12968,2320
40011,Blaine County,Oklahoma,6123,442,623,2230,1362,376,842,248,5058,1090
40013,Bryan County,Oklahoma,31086,1160,2804,10617,7260,1846,4972,2427,27122,7399
40015,Caddo County,Oklahoma,18308,827,1620,8320,3806,978,2030,727,15861,2757
40017,Canadian County,Oklahoma,103902,3008,5342,28294,23780,10189,23238,10051,95552,33289
40019,Carter County,Oklahoma,32134,1101,2952,11589,7540,2658,3668,2626,28081,6294
40021,Cherokee County,Oklahoma,30155,1100,2397,9663,6750,1633,5472,3140,26658,8612
40023,Choctaw County,Oklahoma,9663,493,1014,3710,2273,752,931,490,8156,1421
40025,Cimarron County,Oklahoma,1561,93,102,573,256,42,427,68,1366,495
40027,Cleveland County,Oklahoma,188419,4161,10522,47219,44043,16084,39435,26955,173736,66390
40029,Coal County,Oklahoma,3580,184,400,1519,639,221,374,243,2996,617
40031,Comanche County,Oklahoma,78204,2192,5402,25538,20377,6104,11724,6867,70610,18591
40033,Cotton County,Oklahoma,3845,137,479,1486,876,169,486,212,3229,698
40035,Craig County,Oklahoma,9923,388,1096,3998,2282,829,837,493,8439,1330
40037,Creek County,Oklahoma,49331,1007,3776,19660,11682,4335,6277,2594,44548,8871
40039,Custer County,Oklahoma,16660,802,1187,4557,3894,1047,3459,1714,14671,5173
40041,Delaware County,Oklahoma,29755,1194,3014,11096,6636,2239,3822,1754,25547,5576
40043,Dewey County,Oklahoma,2865,30,168,1273,667,167,369,191,2667,560
40045,Ellis County,Oklahoma,2669,145,214,1012,645,146,367,140,2310,507
40047,Garfield County,Oklahoma,40653,1836,3516,14879,7770,3429,6322,2901,35301,9223
40049,Garvin County,Oklahoma,17251,810,1384,7502,3928,799,1833,995,15057,2828
40051,Grady County,Oklahoma,37546,905,2613,14694,8159,2869,6135,2171,34028,8306
40053,Grant County,Oklahoma,2800,92,132,1053,611,286,446,180,2576,626
40055,Greer County,Oklahoma,3955,107,622,1431,1018,405,304,68,3226,372
40057,Harmon County,Oklahoma,1722,191,153,580,428,115,178,77,1378,255
40059,Harper County,Oklahoma,2238,131,89,717,625,161,391,124,2018,515
40061,Haskell County,Oklahoma,8001,337,906,3267,1537,781,825,348,6758,1173
40063,Hughes County,Oklahoma,9361,362,1118,3872,2032,610,847,520,7881,1367
40065,Jackson County,Oklahoma,15827,1047,1184,4186,3749,1824,2540,1297,13596,3837
40067,Jefferson County,Oklahoma,3647,171,385,1525,800,157,490,119,3091,609
40069,Johnston County,Oklahoma,6859,212,604,2540,1428,639,1016,420,6043,1436
40071,Kay County,Oklahoma,29058,618,2471,9903,7338,3454,3666,1608,25969,5274
40073,Kingfisher County,Oklahoma,9880,421,467,4287,1919,524,1589,673,8992,2262
40075,Kiowa County,Oklahoma,5801,268,566,1861,1685,385,767,269,4967,1036
40077,Latimer County,Oklahoma,6531,198,751,2451,1260,1034,575,262,5582,837
40079,Le Flore County,Oklahoma,32599,1636,3298,13114,6469,3141,3350,1591,27665,4941
40081,Lincoln County,Oklahoma,23240,550,1975,9638,5418,1960,2627,1072,20715,3699
40083,Logan County,Oklahoma,33348,730,2001,10343,7460,2561,7020,3233,30617,10253
40085,Love County,Oklahoma,6767,279,811,2499,1787,357,821,213,5677,1034
40087,McClain County,Oklahoma,28377,730,2422,9056,6559,1992,5141,2477,25225,7618
40089,McCurtain County,Oklahoma,20386,1065,1993,8624,4073,1431,2324,876,17328,3200
40091,McIntosh County,Oklahoma,14058,579,1329,6152,3114,972,1293,619,12150,1912
40093,Major County,Oklahoma,5223,248,237,2257,1145,378,690,268,4738,958
40095,Marshall County,Oklahoma,10666,768,1161,4099,2183,786,1240,429,8737,1669
40097,Mayes County,Oklahoma,26930,874,2047,10785,6465,2624,3088,1047,24009,4135
40099,Murray County,Oklahoma,9532,359,898,3903,2125,579,1233,435,8275,1668
40101,Muskogee County,Oklahoma,44319,1712,4095,15213,9754,4610,6329,2606,38512,8935
40103,Noble County,Oklahoma,7489,233,497,2776,1796,715,1003,469,6759,1472
40105,Nowata County,Oklahoma,6538,158,499,2722,1354,707,797,301,5881,1098
40107,Okfuskee County,Oklahoma,7858,352,949,3131,1784,659,647,336,6557,983
40109,Oklahoma County,Oklahoma,519228,25685,33987,125676,116509,39798,112085,65488,459556,177573
40111,Okmulgee County,Oklahoma,24684,763,2404,8806,5738,3030,2703,1240,21517,3943
40113,Osage County,Oklahoma,32682,788,2655,12119,7364,3201,4458,2097,29239,6555
40115,Ottawa County,Oklahoma,19779,795,1831,6960,5052,2088,2027,1026,17153,3053
40117,Pawnee County,Oklahoma,10787,364,965,4578,2273,839,1354,414,9458,1768
40119,Payne County,Oklahoma,44198,1074,1969,12301,8708,3088,9371,7687,41155,17058
40121,Pittsburg County,Oklahoma,30453,1140,2907,11319,6516,2799,3849,1923,26406,5772
40123,Pontotoc County,Oklahoma,25124,553,2085,8339,5076,1841,4407,2823,22486,7230
40125,Pottawatomie County,Oklahoma,48236,1107,4368,16877,11814,3994,6629,3447,42761,10076
40127,Pushmataha County,Oklahoma,7764,373,859,3416,1516,510,625,465,6532,1090
40129,Roger Mills County,Oklahoma,2362,45,133,810,682,166,334,192,2184,526
40131,Rogers County,Oklahoma,65110,1530,3570,21555,15187,6896,11363,5009,60010,16372
40133,Seminole County,Oklahoma,15607,583,1707,5696,3999,1308,1633,681,13317,2314
40135,Sequoyah County,Oklahoma,26856,1338,3090,10316,5383,2709,2910,1110,22428,4020
40137,Stephens County,Oklahoma,29904,939,2445,12615,6739,1519,3650,1997,26520,5647
40139,Texas County,Oklahoma,13009,2113,1089,3618,2512,491,2092,1094,9807,3186
40141,Tillman County,Oklahoma,4686,449,510,1617,1025,234,574,277,3727,851
40143,Tulsa County,Oklahoma,439813,17358,27070,111432,98637,39163,95513,50640,395385,146153
40145,Wagoner County,Oklahoma,56279,1594,3139,17197,13982,5670,10026,4671,51546,14697
40147,Washington County,Oklahoma,35690,767,2273,11525,7638,2518,7362,3607,32650,10969
40149,Washita County,Oklahoma,7460,162,650,3031,1698,458,903,558,6648,1461
40151,Woods County,Oklahoma,5369,163,381,1647,1263,192,1208,515,4825,1723
40153,Woodward County,Oklahoma,13788,595,1175,5557,3153,649,1836,823,12018,2659
41001,Baker County,Oregon,12415,245,825,3495,3334,1485,2144,887,11345,3031
41003,Benton County,Oregon,58369,888,1458,8505,11375,4758,16602,14783,56023,31385
41005,Clackamas County,Oregon,300373,5993,10960,64861,72625,28222,75770,41942,283420,117712
41007,Clatsop County,Oregon,30595,408,1966,8280,8399,3664,5030,2848,28221,7878
41009,Columbia County,Oregon,38085,717,2882,12713,10639,4137,4649,2348,34486,6997
41011,Coos County,Oregon,48945,977,3906,15163,14044,4788,6212,3855,44062,10067
41013,Crook County,Oregon,18626,373,1443,5804,5020,2096,2726,1164,16810,3890
41015,Curry County,Oregon,19116,515,1189,4973,6185,1722,2672,1860,17412,4532
41017,Deschutes County,Oregon,147063,2879,5554,28254,35245,15179,36988,22964,138630,59952
41019,Douglas County,Oregon,82360,2126,5067,26819,24581,8204,10200,5363,75167,15563
41021,Gilliam County,Oregon,1477,21,129,427,448,128,265,59,1327,324
41023,Grant County,Oregon,5609,135,475,1844,1666,407,738,344,4999,1082
41025,Harney County,Oregon,5499,164,318,2133,1478,627,434,345,5017,779
41027,Hood River County,Oregon,16735,1599,1054,3525,2879,1271,3663,2744,14082,6407
41029,Jackson County,Oregon,160008,4085,10295,41202,42225,14207,29349,18645,145628,47994
41031,Jefferson County,Oregon,17060,854,1215,4989,4703,1680,2512,1107,14991,3619
41033,Josephine County,Oregon,65703,944,4967,20465,20646,6452,7812,4417,59792,12229
41035,Klamath County,Oregon,48771,1434,3780,16442,12247,4704,6512,3652,43557,10164
41037,Lake County,Oregon,6130,394,400,1994,1633,495,794,420,5336,1214
41039,Lane County,Oregon,264813,5787,13169,60194,71942,26417,51671,35633,245857,87304
41041,Lincoln County,Oregon,39183,820,1984,9454,11855,3747,6765,4558,36379,11323
41043,Linn County,Oregon,89890,2297,5941,26482,27643,9156,12039,6332,81652,18371
41045,Malheur County,Oregon,20497,1675,2128,6370,5292,2040,2015,977,16694,2992
41047,Marion County,Oregon,230076,16552,16245,58060,59512,22171,37530,20006,197279,57536
41049,Morrow County,Oregon,7712,800,990,2522,1948,581,547,324,5922,871
41051,Multnomah County,Oregon,598188,21142,24688,100725,122097,44114,171363,114059,552358,285422
41053,Polk County,Oregon,57222,1649,3054,13231,15664,5874,10824,6926,52519,17750
41055,Sherman County,Oregon,1368,43,118,473,353,162,132,87,1207,219
41057,Tillamook County,Oregon,20699,602,1323,5769,6017,2060,3272,1656,18774,4928
41059,Umatilla County,Oregon,52883,3729,4477,16590,12683,5754,6067,3583,44677,9650
41061,Union County,Oregon,17596,332,938,5842,4818,1472,2916,1278,16326,4194
41063,Wallowa County,Oregon,5608,89,286,1525,1491,424,1126,667,5233,1793
41065,Wasco County,Oregon,18770,1116,1430,5008,4907,2171,2493,1645,16224,4138
41067,Washington County,Oregon,417204,15758,14008,71673,88268,36329,116615,74553,387438,191168
41069,Wheeler County,Oregon,1101,13,79,354,306,129,130,90,1009,220
41071,Yamhill County,Oregon,73347,2890,4516,17902,20415,6163,13608,7853,65941,21461
42001,Adams County,Pennsylvania,73526,2418,4703,29577,12522,6378,10195,7733,66405,17928
42003,Allegheny County,Pennsylvania,902730,13623,29392,233029,140104,90874,229538,166170,859715,395708
42005,Armstrong County,Pennsylvania,48608,1060,2614,23783,7089,5027,6171,2864,44934,9035
42007,Beaver County,Pennsylvania,123142,1771,4814,45027,22929,15643,22588,10370,116557,32958
42009,Bedford County,Pennsylvania,34889,988,2397,16996,5560,3332,3396,2220,31504,5616
42011,Berks County,Pennsylvania,292213,13887,20977,106889,45098,26999,50120,28243,257349,78363
42013,Blair County,Pennsylvania,87416,1637,4515,39157,13666,7956,13677,6808,81264,20485
42015,Bradford County,Pennsylvania,42551,1059,2923,20049,6091,3909,5202,3318,38569,8520
42017,Bucks County,Pennsylvania,464065,8313,16367,128984,71392,38040,119275,81694,439385,200969
42019,Butler County,Pennsylvania,139574,1467,4583,44716,20295,15013,33619,19881,133524,53500
42021,Cambria County,Pennsylvania,95844,1959,4955,42565,14360,10276,14836,6893,88930,21729
42023,Cameron County,Pennsylvania,3476,55,202,1804,694,343,302,76,3219,378
42025,Carbon County,Pennsylvania,48059,1509,3451,21172,7919,5198,5999,2811,43099,8810
42027,Centre County,Pennsylvania,97184,2082,2966,27918,11923,7392,21837,23066,92136,44903
42029,Chester County,Pennsylvania,367451,9169,10138,71079,48032,22825,120444,85764,348144,206208
42031,Clarion County,Pennsylvania,25480,762,1561,11833,3098,2430,3634,2162,23157,5796
42033,Clearfield County,Pennsylvania,59485,1880,4150,27923,7988,6167,7564,3813,53455,11377
42035,Clinton County,Pennsylvania,25001,797,1818,11519,3475,2317,3283,1792,22386,5075
42037,Columbia County,Pennsylvania,43527,986,2652,19292,5874,3639,6764,4320,39889,11084
42039,Crawford County,Pennsylvania,58926,2106,3409,27952,8670,4657,7559,4573,53411,12132
42041,Cumberland County,Pennsylvania,181984,4283,7552,56919,27828,15037,43025,27340,170149,70365
42043,Dauphin County,Pennsylvania,198441,6571,10928,64050,32017,18834,42075,23966,180942,66041
42045,Delaware County,Pennsylvania,391672,8686,16762,108272,66319,31545,91675,68413,366224,160088
42047,Elk County,Pennsylvania,22721,414,1144,11415,2740,2808,2889,1311,21163,4200
42049,Erie County,Pennsylvania,186684,4217,9755,69704,28952,18858,34409,20789,172712,55198
42051,Fayette County,Pennsylvania,94625,2294,7322,45298,13413,8655,11625,6018,85009,17643
42053,Forest County,Pennsylvania,5716,208,604,3043,982,217,492,170,4904,662
42055,Franklin County,Pennsylvania,110146,3062,7719,48095,16782,9191,15426,9871,99365,25297
42057,Fulton County,Pennsylvania,10579,344,777,5235,1426,1072,1014,711,9458,1725
42059,Greene County,Pennsylvania,25538,670,2031,11277,4042,2126,3478,1914,22837,5392
42061,Huntingdon County,Pennsylvania,31981,951,2234,15970,4425,2625,3819,1957,28796,5776
42063,Indiana County,Pennsylvania,54397,1508,2843,22264,8364,5165,8056,6197,50046,14253
42065,Jefferson County,Pennsylvania,31574,970,1809,16198,4011,3222,3514,1850,28795,5364
42067,Juniata County,Pennsylvania,16493,928,1883,8000,2018,1299,1582,783,13682,2365
42069,Lackawanna County,Pennsylvania,151972,4003,8826,54011,24345,15345,27715,17727,139143,45442
42071,Lancaster County,Pennsylvania,374869,23892,24999,129395,53118,29062,73258,41145,325978,114403
42073,Lawrence County,Pennsylvania,61794,1315,3651,26438,10718,6055,9710,3907,56828,13617
42075,Lebanon County,Pennsylvania,98487,4276,8021,41287,14606,7792,14402,8103,86190,22505
42077,Lehigh County,Pennsylvania,255117,9970,14909,82057,41889,23753,50875,31664,230238,82539
42079,Luzerne County,Pennsylvania,231289,8220,13792,87414,40300,24808,34996,21759,209277,56755
42081,Lycoming County,Pennsylvania,80154,1814,5591,30863,12724,9629,12691,6842,72749,19533
42083,McKean County,Pennsylvania,28826,746,1326,13613,4488,3034,3454,2165,26754,5619
42085,Mercer County,Pennsylvania,78929,2516,4977,32261,12430,7724,12182,6839,71436,19021
42087,Mifflin County,Pennsylvania,32350,1489,3436,15905,4531,2731,2745,1513,27425,4258
42089,Monroe County,Pennsylvania,118803,3589,8416,41978,22595,10675,19037,12513,106798,31550
42091,Montgomery County,Pennsylvania,603213,11682,19794,136287,81699,43499,174882,135370,571737,310252
42093,Montour County,Pennsylvania,13288,374,604,4613,1726,1134,2401,2436,12310,4837
42095,Northampton County,Pennsylvania,220129,5756,11956,72910,35792,21425,44339,27951,202417,72290
42097,Northumberland County,Pennsylvania,66933,1817,4937,32188,9690,5940,8572,3789,60179,12361
42099,Perry County,Pennsylvania,33078,1105,2485,15288,4792,3367,4113,1928,29488,6041
42101,Philadelphia County,Pennsylvania,1090012,54306,88451,330553,183642,66750,204967,161343,947255,366310
42103,Pike County,Pennsylvania,44410,724,2350,15114,9753,4297,6914,5258,41336,12172
42105,Potter County,Pennsylvania,11947,338,844,5647,1978,1148,1288,704,10765,1992
42107,Schuylkill County,Pennsylvania,104476,2798,8002,46921,15904,11557,12953,6341,93676,19294
42109,Snyder County,Pennsylvania,26578,1671,2338,11683,2962,2340,3395,2189,22569,5584
42111,Somerset County,Pennsylvania,55224,1901,3605,27130,7845,5228,6167,3348,49718,9515
42113,Sullivan County,Pennsylvania,4861,55,394,2361,564,569,624,294,4412,918
42115,Susquehanna County,Pennsylvania,28648,469,1954,13244,4646,2638,3627,2070,26225,5697
42117,Tioga County,Pennsylvania,29481,531,1911,12937,4988,2829,3871,2414,27039,6285
42119,Union County,Pennsylvania,29049,1211,2769,12287,3219,2286,3850,3427,25069,7277
42121,Venango County,Pennsylvania,37461,1101,2359,17364,5651,3723,4795,2468,34001,7263
42123,Warren County,Pennsylvania,28337,496,1285,13108,4866,3212,3514,1856,26556,5370
42125,Washington County,Pennsylvania,151239,2690,6365,54324,22866,16000,31275,17719,142184,48994
42127,Wayne County,Pennsylvania,39339,701,2606,17328,6831,3680,4811,3382,36032,8193
42129,Westmoreland County,Pennsylvania,263459,3382,8885,93616,43719,31641,52112,30104,251192,82216
42131,Wyoming County,Pennsylvania,18901,247,1120,8610,3153,1713,2618,1440,17534,4058
42133,York County,Pennsylvania,319732,8288,20179,123005,53307,30739,53120,31094,291265,84214
44001,Bristol County,Rhode Island,35419,857,1528,7503,5054,2280,9708,8489,33034,18197
44003,Kent County,Rhode Island,126563,3059,6121,35488,25945,13459,26052,16439,117383,42491
44005,Newport County,Rhode Island,63786,1370,1964,12624,9986,4603,19260,13979,60452,33239
44007,Providence County,Rhode Island,454952,30472,31903,132887,82127,35637,86194,55732,392577,141926
44009,Washington County,Rhode Island,90564,1119,3542,18709,15788,7434,24273,19699,85903,43972
45001,Abbeville County,South Carolina,17149,838,1714,6680,2622,2026,2311,958,14597,3269
45003,Aiken County,South Carolina,120157,4403,8131,36634,24861,10560,22589,12979,107623,35568
45005,Allendale County,South Carolina,5670,208,990,2375,1070,416,349,262,4472,611
45007,Anderson County,South Carolina,140512,4780,13265,42422,27031,16287,23038,13689,122467,36727
45009,Bamberg County,South Carolina,8978,577,1460,2762,1555,1021,894,709,6941,1603
45011,Barnwell County,South Carolina,13769,1000,1370,5407,2320,1698,1250,724,11399,1974
45013,Beaufort County,South Carolina,136528,2880,5806,29089,27893,11624,34024,25212,127842,59236
45015,Berkeley County,South Carolina,154846,4735,10630,44576,35012,15979,28413,15501,139481,43914
45017,Calhoun County,South Carolina,10500,618,796,3660,2086,1330,1324,686,9086,2010
45019,Charleston County,South Carolina,295540,6104,14772,57778,50005,24747,87624,54510,274664,142134
45021,Cherokee County,South Carolina,38207,1524,4136,14398,7742,3829,3885,2693,32547,6578
45023,Chester County,South Carolina,22441,799,2525,9282,4545,2181,1948,1161,19117,3109
45025,Chesterfield County,South Carolina,30442,1852,3816,12208,5930,2718,2469,1449,24774,3918
45027,Clarendon County,South Carolina,22550,1002,3315,8274,4530,1687,2423,1319,18233,3742
45029,Colleton County,South Carolina,26939,995,2727,10926,5074,3000,2764,1453,23217,4217
45031,Darlington County,South Carolina,43315,2020,4172,15886,8235,4771,5138,3093,37123,8231
45033,Dillon County,South Carolina,18693,1209,2841,7901,3026,1496,1306,914,14643,2220
45035,Dorchester County,South Carolina,109799,3122,7190,27851,26608,12707,21108,11213,99487,32321
45037,Edgefield County,South Carolina,19108,913,2335,6628,3518,1916,2260,1538,15860,3798
45039,Fairfield County,South Carolina,15303,562,1872,6054,3206,1357,1386,866,12869,2252
45041,Florence County,South Carolina,92542,3180,8582,30922,17460,10377,13742,8279,80780,22021
45043,Georgetown County,South Carolina,48042,1191,3203,12989,10663,5112,9331,5553,43648,14884
45045,Greenville County,South Carolina,361179,11824,23940,82827,67618,33036,89919,52015,325415,141934
45047,Greenwood County,South Carolina,46557,1835,4270,14990,8007,6174,7245,4036,40452,11281
45049,Hampton County,South Carolina,13205,929,1590,5726,2370,1063,954,573,10686,1527
45051,Horry County,South Carolina,266541,6858,15598,86619,61724,28151,43751,23840,244085,67591
45053,Jasper County,South Carolina,21362,675,1499,7886,4261,2068,3619,1354,19188,4973
45055,Kershaw County,South Carolina,45757,1560,3517,15634,10459,4827,5882,3878,40680,9760
45057,Lancaster County,South Carolina,70340,2642,5056,19859,13848,7779,13656,7500,62642,21156
45059,Laurens County,South Carolina,46889,2762,5353,16940,8472,4961,5563,2838,38774,8401
45061,Lee County,South Carolina,11745,708,1501,4835,2143,861,1070,627,9536,1697
45063,Lexington County,South Carolina,205290,5762,12199,54527,44208,21659,42345,24590,187329,66935
45065,McCormick County,South Carolina,7986,411,774,2724,1364,1015,1164,534,6801,1698
45067,Marion County,South Carolina,20292,929,2212,10149,2682,1535,1742,1043,17151,2785
45069,Marlboro County,South Carolina,19034,981,2751,9433,2931,1360,1024,554,15302,1578
45071,Newberry County,South Carolina,25949,1358,2416,8298,4865,3170,3469,2373,22175,5842
45073,Oconee County,South Carolina,57617,2205,5315,16978,10866,6236,9502,6515,50097,16017
45075,Orangeburg County,South Carolina,56778,2302,6628,18640,10509,7823,5784,5092,47848,10876
45077,Pickens County,South Carolina,82774,2903,7814,25024,15291,9000,12364,10378,72057,22742
45079,Richland County,South Carolina,263144,5475,15044,56254,56407,24079,61080,44805,242625,105885
45081,Saluda County,South Carolina,13321,970,1270,5008,2188,1329,1473,1083,11081,2556
45083,Spartanburg County,South Carolina,223505,9877,17321,69508,47233,23160,34691,21715,196307,56406
45085,Sumter County,South Carolina,69519,2292,5490,22075,16049,7573,9530,6510,61737,16040
45087,Union County,South Carolina,19408,1068,2508,7449,3687,1991,1998,707,15832,2705
45089,Williamsburg County,South Carolina,22458,1044,2793,9494,3717,1987,1977,1446,18621,3423
45091,York County,South Carolina,191641,4714,10100,45976,40284,19942,44962,25663,176827,70625
46003,Aurora County,South Dakota,1724,79,71,634,305,321,232,82,1574,314
46005,Beadle County,South Dakota,12532,1181,686,4136,2068,1267,2077,1117,10665,3194
46007,Bennett County,South Dakota,1797,54,146,622,453,192,270,60,1597,330
46009,Bon Homme County,South Dakota,5171,196,378,1908,1007,644,721,317,4597,1038
46011,Brookings County,South Dakota,18716,214,497,4341,3559,2164,5202,2739,18005,7941
46013,Brown County,South Dakota,25369,564,1045,7843,4619,2973,6111,2214,23760,8325
46015,Brule County,South Dakota,3576,338,170,1222,553,373,694,226,3068,920
46017,Buffalo County,South Dakota,911,10,150,403,194,92,47,15,751,62
46019,Butte County,South Dakota,7263,291,479,2749,1661,763,924,396,6493,1320
46021,Campbell County,South Dakota,1111,60,82,330,231,93,278,37,969,315
46023,Charles Mix County,South Dakota,5655,251,344,1998,894,771,1052,345,5060,1397
46025,Clark County,South Dakota,2554,144,83,1093,529,228,401,76,2327,477
46027,Clay County,South Dakota,7334,142,342,2079,1242,595,1540,1394,6850,2934
46029,Codington County,South Dakota,19341,655,925,7685,3458,2717,2721,1180,17761,3901
46031,Corson County,South Dakota,2139,37,258,797,386,294,298,69,1844,367
46033,Custer County,South Dakota,6941,205,236,2243,1505,635,1248,869,6500,2117
46035,Davison County,South Dakota,13591,532,795,4636,2881,1586,2509,652,12264,3161
46037,Day County,South Dakota,3909,141,191,1419,722,560,652,224,3577,876
46039,Deuel County,South Dakota,2941,71,140,1039,619,375,567,130,2730,697
46041,Dewey County,South Dakota,2792,43,331,1078,559,282,346,153,2418,499
46043,Douglas County,South Dakota,1894,66,99,683,399,257,323,67,1729,390
46045,Edmunds County,South Dakota,2874,137,76,898,581,373,617,192,2661,809
46047,Fall River County,South Dakota,5482,174,290,1868,1347,714,651,438,5018,1089
46049,Faulk County,South Dakota,1440,50,62,428,344,237,198,121,1328,319
46051,Grant County,South Dakota,5257,174,264,2006,873,657,863,420,4819,1283
46053,Gregory County,South Dakota,2773,67,200,1067,618,290,331,200,2506,531
46055,Haakon County,South Dakota,1233,3,42,580,276,127,187,18,1188,205
46057,Hamlin County,South Dakota,3619,191,85,1438,687,426,573,219,3343,792
46059,Hand County,South Dakota,2123,99,48,616,417,405,427,111,1976,538
46061,Hanson County,South Dakota,2121,75,38,720,391,449,336,112,2008,448
46063,Harding County,South Dakota,863,33,18,269,249,58,202,34,812,236
46065,Hughes County,South Dakota,12296,149,258,3362,2584,1588,3053,1302,11889,4355
46067,Hutchinson County,South Dakota,4982,211,189,1554,1057,688,962,321,4582,1283
46069,Hyde County,South Dakota,993,28,63,310,192,198,163,39,902,202
46071,Jackson County,South Dakota,1712,63,158,639,360,225,196,71,1491,267
46073,Jerauld County,South Dakota,1396,50,66,639,210,196,167,68,1280,235
46075,Jones County,South Dakota,670,0,34,232,110,67,173,54,636,227
46077,Kingsbury County,South Dakota,3532,163,174,1324,625,435,590,221,3195,811
46079,Lake County,South Dakota,7737,147,369,2062,1647,839,1926,747,7221,2673
46081,Lawrence County,South Dakota,18355,353,569,4861,3922,1914,4574,2162,17433,6736
46083,Lincoln County,South Dakota,42903,532,1179,10236,7315,5706,12192,5743,41192,17935
46085,Lyman County,South Dakota,2317,26,172,945,475,162,391,146,2119,537
46087,McCook County,South Dakota,3712,176,100,1278,668,462,730,298,3436,1028
46089,McPherson County,South Dakota,1663,207,107,622,229,157,273,68,1349,341
46091,Marshall County,South Dakota,3029,190,103,1024,506,500,608,98,2736,706
46093,Meade County,South Dakota,20199,189,656,5788,5256,2779,4198,1333,19354,5531
46095,Mellette County,South Dakota,1248,63,162,508,221,145,115,34,1023,149
46097,Miner County,South Dakota,1661,81,77,714,359,156,224,50,1503,274
46099,Minnehaha County,South Dakota,130706,3798,5219,33095,27087,16834,31242,13431,121689,44673
46101,Moody County,South Dakota,4236,114,120,1327,928,603,732,412,4002,1144
46102,Oglala Lakota County,South Dakota,6994,154,1668,2465,1653,484,402,168,5172,570
46103,Pennington County,South Dakota,76300,1655,2791,21328,16359,8699,16226,9242,71854,25468
46105,Perkins County,South Dakota,2101,46,117,719,464,330,320,105,1938,425
46107,Potter County,South Dakota,1811,36,26,764,321,224,363,77,1749,440
46109,Roberts County,South Dakota,6443,145,427,2371,1397,1038,759,306,5871,1065
46111,Sanborn County,South Dakota,1583,33,95,646,283,211,221,94,1455,315
46115,Spink County,South Dakota,4513,244,178,1545,939,476,916,215,4091,1131
46117,Stanley County,South Dakota,2130,38,84,763,395,278,362,210,2008,572
46119,Sully County,South Dakota,1032,4,35,397,217,157,190,32,993,222
46121,Todd County,South Dakota,4695,250,698,1314,1481,260,431,261,3747,692
46123,Tripp County,South Dakota,4057,106,307,1668,843,440,551,142,3644,693
46125,Turner County,South Dakota,5989,195,322,1936,1134,818,1195,389,5472,1584
46127,Union County,South Dakota,11461,245,390,3155,2199,1412,2528,1532,10826,4060
46129,Walworth County,South Dakota,3768,138,194,1290,617,487,743,299,3436,1042
46135,Yankton County,South Dakota,16238,392,732,5733,3006,1945,2822,1608,15114,4430
46137,Ziebach County,South Dakota,1479,16,138,620,314,171,177,43,1325,220
47001,Anderson County,Tennessee,55143,1915,3119,18467,12964,5152,7440,6086,50109,13526
47003,Bedford County,Tennessee,33792,1903,3157,14073,7127,1747,4051,1734,28732,5785
47005,Benton County,Tennessee,11591,686,1090,5356,2335,837,733,554,9815,1287
47007,Bledsoe County,Tennessee,11441,809,1695,5268,1838,648,728,455,8937,1183
47009,Blount County,Tennessee,98165,3182,6212,34840,19867,8520,16230,9314,88771,25544
47011,Bradley County,Tennessee,74607,3112,5694,23262,17279,7436,11018,6806,65801,17824
47013,Campbell County,Tennessee,28408,1879,3470,11727,5854,1801,2147,1530,23059,3677
47015,Cannon County,Tennessee,10328,473,1013,4329,1965,741,1210,597,8842,1807
47017,Carroll County,Tennessee,19421,897,1292,8311,3681,1392,2302,1546,17232,3848
47019,Carter County,Tennessee,42063,1782,3502,15454,8982,3459,5687,3197,36779,8884
47021,Cheatham County,Tennessee,29340,1270,1973,11262,6021,2097,4408,2309,26097,6717
47023,Chester County,Tennessee,11286,371,1255,4653,2625,536,1130,716,9660,1846
47025,Claiborne County,Tennessee,23056,1881,2226,8832,3741,2052,2502,1822,18949,4324
47027,Clay County,Tennessee,5510,407,421,2670,990,344,434,244,4682,678
47029,Cocke County,Tennessee,26270,1747,2329,12701,4664,1748,2026,1055,22194,3081
47031,Coffee County,Tennessee,39473,1496,3468,14880,7391,3030,5443,3765,34509,9208
47033,Crockett County,Tennessee,9480,481,870,3927,2024,706,993,479,8129,1472
47035,Cumberland County,Tennessee,47524,1870,3229,19328,10550,3943,5206,3398,42425,8604
47037,Davidson County,Tennessee,495381,18592,29284,102676,87705,29324,140915,86885,447505,227800
47039,Decatur County,Tennessee,8322,426,818,3819,1316,642,1048,253,7078,1301
47041,DeKalb County,Tennessee,14386,988,1732,5694,2427,610,2014,921,11666,2935
47043,Dickson County,Tennessee,37919,1442,2972,14811,8141,3229,4656,2668,33505,7324
47045,Dyer County,Tennessee,25019,1048,1909,9757,4969,1926,3266,2144,22062,5410
47047,Fayette County,Tennessee,31529,805,2266,10363,7422,2578,5475,2620,28458,8095
47049,Fentress County,Tennessee,13453,1529,1039,5220,2535,934,1525,671,10885,2196
47051,Franklin County,Tennessee,29560,1091,1872,12289,5620,2243,3910,2535,26597,6445
47053,Gibson County,Tennessee,34441,1472,2794,14062,7674,2054,3968,2417,30175,6385
47055,Giles County,Tennessee,21382,837,1720,9302,3908,1565,2632,1418,18825,4050
47057,Grainger County,Tennessee,17170,1316,1946,7197,3285,1006,1377,1043,13908,2420
47059,Greene County,Tennessee,50666,2649,4225,21857,9545,3282,5678,3430,43792,9108
47061,Grundy County,Tennessee,9623,766,1202,4242,1506,603,660,644,7655,1304
47063,Hamblen County,Tennessee,44329,2647,3382,17699,8896,3354,5279,3072,38300,8351
47065,Hamilton County,Tennessee,259234,9316,14790,61627,58644,22701,58187,33969,235128,92156
47067,Hancock County,Tennessee,4850,447,533,2136,1094,161,193,286,3870,479
47069,Hardeman County,Tennessee,18436,790,2723,7734,4127,1130,1296,636,14923,1932
47071,Hardin County,Tennessee,19378,903,1931,8541,3671,1270,2129,933,16544,3062
47073,Hawkins County,Tennessee,41611,2029,3722,17632,8269,2982,4684,2293,35860,6977
47075,Haywood County,Tennessee,12484,772,1444,5614,2400,736,898,620,10268,1518
47077,Henderson County,Tennessee,19260,771,1567,9442,3411,1403,1815,851,16922,2666
47079,Henry County,Tennessee,23375,1236,1779,10397,4327,1191,2900,1545,20360,4445
47081,Hickman County,Tennessee,17892,1076,2052,7550,3508,1480,1583,643,14764,2226
47083,Houston County,Tennessee,5809,316,611,2677,908,634,414,249,4882,663
47085,Humphreys County,Tennessee,13339,499,1200,6057,2165,1168,1442,808,11640,2250
47087,Jackson County,Tennessee,8770,732,911,4023,1348,535,981,240,7127,1221
47089,Jefferson County,Tennessee,39459,1769,2961,14391,8363,3656,5119,3200,34729,8319
47091,Johnson County,Tennessee,13727,798,1615,5442,2801,1020,1333,718,11314,2051
47093,Knox County,Tennessee,322573,8432,16259,80673,61850,29071,77209,49079,297882,126288
47095,Lake County,Tennessee,5264,430,924,2221,910,209,339,231,3910,570
47097,Lauderdale County,Tennessee,17136,801,2291,8060,3088,1108,1089,699,14044,1788
47099,Lawrence County,Tennessee,29839,2124,2125,12919,5817,2188,2807,1859,25590,4666
47101,Lewis County,Tennessee,8743,644,724,3713,2122,724,575,241,7375,816
47103,Lincoln County,Tennessee,24770,791,2162,10845,4229,1958,2881,1904,21817,4785
47105,Loudon County,Tennessee,41137,1860,3156,12829,8485,3143,7356,4308,36121,11664
47107,McMinn County,Tennessee,37686,1932,3198,14482,7973,3541,4266,2294,32556,6560
47109,McNairy County,Tennessee,18281,806,1694,8715,3577,1394,1202,893,15781,2095
47111,Macon County,Tennessee,16887,1384,2329,7968,2515,1024,1091,576,13174,1667
47113,Madison County,Tennessee,66475,1870,5011,22438,15030,4887,10415,6824,59594,17239
47115,Marion County,Tennessee,20693,1411,2552,7826,4238,1532,1922,1212,16730,3134
47117,Marshall County,Tennessee,23527,825,1723,8730,5075,2263,3399,1512,20979,4911
47119,Maury County,Tennessee,70957,2316,3512,23379,15815,7590,12487,5858,65129,18345
47121,Meigs County,Tennessee,9322,598,1069,3972,2049,562,680,392,7655,1072
47123,Monroe County,Tennessee,33502,2214,2563,13638,7162,2692,3581,1652,28725,5233
47125,Montgomery County,Tennessee,137996,2439,5642,37460,34162,16401,26757,15135,129915,41892
47127,Moore County,Tennessee,4787,268,395,1876,695,444,731,378,4124,1109
47129,Morgan County,Tennessee,15303,993,1847,6682,2714,1159,1123,785,12463,1908
47131,Obion County,Tennessee,21643,1186,2095,9783,3822,1029,2351,1377,18362,3728
47133,Overton County,Tennessee,15952,1340,1495,7256,2857,788,1427,789,13117,2216
47135,Perry County,Tennessee,5793,693,465,2630,909,475,410,211,4635,621
47137,Pickett County,Tennessee,3784,238,461,1475,742,179,449,240,3085,689
47139,Polk County,Tennessee,12893,923,1051,4898,2772,1532,1062,655,10919,1717
47141,Putnam County,Tennessee,51667,2356,3209,17954,10749,3152,8994,5253,46102,14247
47143,Rhea County,Tennessee,22843,1088,2723,9241,4485,1399,2666,1241,19032,3907
47145,Roane County,Tennessee,39812,1353,2675,14756,8592,3723,5161,3552,35784,8713
47147,Robertson County,Tennessee,50350,2030,3688,19734,10221,4066,7875,2736,44632,10611
47149,Rutherford County,Tennessee,217950,6128,9782,60797,50394,18084,50052,22713,202040,72765
47151,Scott County,Tennessee,14918,956,1971,6853,2609,1000,920,609,11991,1529
47153,Sequatchie County,Tennessee,11627,571,1292,4469,2334,801,1418,742,9764,2160
47155,Sevier County,Tennessee,71045,2971,5781,25534,16508,5959,9547,4745,62293,14292
47157,Shelby County,Tennessee,610776,21304,42000,168477,132456,40162,123239,83138,547472,206377
47159,Smith County,Tennessee,14009,555,1320,5953,2834,980,1607,760,12134,2367
47161,Stewart County,Tennessee,9715,415,699,4441,1774,754,1177,455,8601,1632
47163,Sullivan County,Tennessee,116111,4371,8021,38159,23445,11565,20213,10337,103719,30550
47165,Sumner County,Tennessee,135793,4111,7639,39658,29937,12040,28742,13666,124043,42408
47167,Tipton County,Tennessee,41274,1481,3046,14858,9683,4100,5128,2978,36747,8106
47169,Trousdale County,Tennessee,8371,334,842,4117,1705,556,452,365,7195,817
47171,Unicoi County,Tennessee,13289,544,1051,5039,3390,975,1538,752,11694,2290
47173,Union County,Tennessee,14064,1128,1633,5962,2326,1175,989,851,11303,1840
47175,Van Buren County,Tennessee,4588,433,458,2181,711,337,265,203,3697,468
47177,Warren County,Tennessee,28286,1627,2971,13419,4477,1843,2746,1203,23688,3949
47179,Washington County,Tennessee,91259,2771,5414,26184,19672,6765,17509,12944,83074,30453
47181,Wayne County,Tennessee,12219,772,1393,5438,2358,773,1024,461,10054,1485
47183,Weakley County,Tennessee,21122,1022,1614,9588,3617,1034,2657,1590,18486,4247
47185,White County,Tennessee,19417,1369,2173,7763,3964,1519,1742,887,15875,2629
47187,Williamson County,Tennessee,163046,2828,3637,22128,22741,10645,63976,37091,156581,101067
47189,Wilson County,Tennessee,102516,2664,4438,29637,19833,8280,25090,12574,95414,37664
48001,Anderson County,Texas,42436,2330,4131,16205,10329,3877,3857,1707,35975,5564
48003,Andrews County,Texas,11043,1600,1290,3222,1912,844,1636,539,8153,2175
48005,Angelina County,Texas,56714,4181,4899,18290,13873,4894,6706,3871,47634,10577
48007,Aransas County,Texas,19026,1025,1142,6057,4850,1354,2992,1606,16859,4598
48009,Archer County,Texas,6034,147,386,2250,1266,466,1023,496,5501,1519
48011,Armstrong County,Texas,1331,53,43,441,326,123,235,110,1235,345
48013,Atascosa County,Texas,31538,2665,3465,12558,6610,1659,3483,1098,25408,4581
48015,Austin County,Texas,20958,1234,1306,6819,5122,1420,3753,1304,18418,5057
48017,Bailey County,Texas,4342,439,723,1461,817,236,482,184,3180,666
48019,Bandera County,Texas,16279,443,864,4822,3958,1742,2783,1667,14972,4450
48021,Bastrop County,Texas,64589,5980,4951,19628,15247,3896,10118,4769,53658,14887
48023,Baylor County,Texas,2468,56,265,905,492,176,481,93,2147,574
48025,Bee County,Texas,21600,1679,2590,7195,5811,1842,1474,1009,17331,2483
48027,Bell County,Texas,227732,7969,12946,58840,63349,23658,40173,20797,206817,60970
48029,Bexar County,Texas,1297977,85729,97461,318848,290630,110312,244258,150739,1114787,394997
48031,Blanco County,Texas,8849,443,413,2388,2098,797,2112,598,7993,2710
48033,Borden County,Texas,439,10,14,93,113,36,128,45,415,173
48035,Bosque County,Texas,13281,594,1041,4259,3641,1227,1793,726,11646,2519
48037,Bowie County,Texas,62699,2126,4157,22138,15259,5068,8817,5134,56416,13951
48039,Brazoria County,Texas,245242,12296,15223,60400,58169,22126,49553,27475,217723,77028
48041,Brazos County,Texas,123121,6259,6942,25985,22533,8211,28990,24201,109920,53191
48043,Brewster County,Texas,7149,298,494,1177,1540,230,2039,1371,6357,3410
48045,Briscoe County,Texas,978,76,75,338,221,114,94,60,827,154
48047,Brooks County,Texas,4914,617,850,1521,942,45,691,248,3447,939
48049,Brown County,Texas,26536,1031,2316,8848,7108,1956,3901,1376,23189,5277
48051,Burleson County,Texas,12878,694,1403,4375,2624,889,2102,791,10781,2893
48053,Burnet County,Texas,35526,2286,1828,10454,8697,2272,6892,3097,31412,9989
48055,Caldwell County,Texas,30562,2255,3769,11478,6639,1320,3641,1460,24538,5101
48057,Calhoun County,Texas,13619,1031,1102,4730,3303,1246,1377,830,11486,2207
48059,Callahan County,Texas,9723,187,583,3514,2443,772,1699,525,8953,2224
48061,Cameron County,Texas,250129,41455,31439,64955,44776,18792,33806,14906,177235,48712
48063,Camp County,Texas,8192,559,488,3096,1789,562,1203,495,7145,1698
48065,Carson County,Texas,3905,77,219,1286,981,357,681,304,3609,985
48067,Cass County,Texas,20037,682,1793,8466,4114,1531,2473,978,17562,3451
48069,Castro County,Texas,4499,827,291,1507,763,234,669,208,3381,877
48071,Chambers County,Texas,29931,1678,1545,8021,8942,2924,4752,2069,26708,6821
48073,Cherokee County,Texas,33407,3074,3975,10812,7561,2582,3423,1980,26358,5403
48075,Childress County,Texas,4993,306,593,1871,1205,287,526,205,4094,731
48077,Clay County,Texas,7534,208,325,2673,2025,552,1229,522,7001,1751
48079,Cochran County,Texas,1689,344,173,574,270,184,103,41,1172,144
48081,Coke County,Texas,2385,132,201,776,657,154,295,170,2052,465
48083,Coleman County,Texas,5588,400,260,1641,1759,374,875,279,4928,1154
48085,Collin County,Texas,711181,21138,19038,104707,126952,53247,240100,145999,671005,386099
48087,Collingsworth County,Texas,1786,154,243,413,342,184,359,91,1389,450
48089,Colorado County,Texas,14013,1156,1028,4896,2978,848,2208,899,11829,3107
48091,Comal County,Texas,115639,2868,4520,26807,25372,9195,30280,16597,108251,46877
48093,Comanche County,Texas,9615,656,822,3185,2288,849,1214,601,8137,1815
48095,Concho County,Texas,2474,347,274,913,527,127,216,70,1853,286
48097,Cooke County,Texas,28556,1414,1785,8948,7250,2514,4462,2183,25357,6645
48099,Coryell County,Texas,52395,1977,3259,14933,17637,5523,6302,2764,47159,9066
48101,Cottle County,Texas,1097,77,122,315,296,86,129,72,898,201
48103,Crane County,Texas,2894,546,177,1091,559,68,319,134,2171,453
48105,Crockett County,Texas,2344,294,364,662,611,47,215,151,1686,366
48107,Crosby County,Texas,3413,327,430,1289,659,229,394,85,2656,479
48109,Culberson County,Texas,1688,318,81,849,262,1,164,13,1289,177
48111,Dallam County,Texas,4467,837,144,1768,959,120,559,80,3486,639
48113,Dallas County,Texas,1681632,172962,144376,379639,312289,102577,353037,216752,1364294,569789
48115,Dawson County,Texas,7853,1138,1202,2680,1367,406,902,158,5513,1060
48117,Deaf Smith County,Texas,10827,1764,1250,4445,1691,396,952,329,7813,1281
48119,Delta County,Texas,3691,174,225,1295,827,377,549,244,3292,793
48121,Denton County,Texas,611044,19033,22065,103411,126064,47987,193763,98721,569946,292484
48123,DeWitt County,Texas,13944,926,1291,5927,2698,1141,1409,552,11727,1961
48125,Dickens County,Texas,1174,69,101,467,213,87,159,78,1004,237
48127,Dimmit County,Texas,5327,1037,414,1858,1099,142,429,348,3876,777
48129,Donley County,Texas,2155,83,252,734,598,197,191,100,1820,291
48131,Duval County,Texas,6380,872,824,2212,1521,452,284,215,4684,499
48133,Eastland County,Texas,12158,643,1131,3647,2956,1002,1826,953,10384,2779
48135,Ector County,Texas,96948,9855,12591,28763,21814,7829,10918,5178,74502,16096
48137,Edwards County,Texas,841,131,84,151,232,83,126,34,626,160
48139,Ellis County,Texas,125963,6524,8154,34203,31343,10634,24046,11059,111285,35105
48141,El Paso County,Texas,535173,62651,44245,129988,116159,48269,90357,43504,428277,133861
48143,Erath County,Texas,25212,1597,1659,6648,5093,2056,5542,2617,21956,8159
48145,Falls County,Texas,11605,698,1331,3887,3230,895,1027,537,9576,1564
48147,Fannin County,Texas,25287,1437,2174,8844,5945,1685,3356,1846,21676,5202
48149,Fayette County,Texas,18005,906,914,7155,3422,1276,3179,1153,16185,4332
48151,Fisher County,Texas,2608,202,159,898,533,297,353,166,2247,519
48153,Floyd County,Texas,3488,464,539,983,699,244,429,130,2485,559
48155,Foard County,Texas,698,56,81,171,203,75,81,31,561,112
48157,Fort Bend County,Texas,536035,24973,20742,95805,96284,37609,156424,104198,490320,260622
48159,Franklin County,Texas,7328,260,363,2054,1867,533,1459,792,6705,2251
48161,Freestone County,Texas,13871,719,1365,4780,3116,1480,1649,762,11787,2411
48163,Frio County,Texas,11719,1422,2093,4575,1918,713,607,391,8204,998
48165,Gaines County,Texas,11665,3353,1269,3857,1239,734,955,258,7043,1213
48167,Galveston County,Texas,236769,10003,14304,55331,55000,22089,53733,26309,212462,80042
48169,Garza County,Texas,4158,647,601,1362,886,110,313,239,2910,552
48171,Gillespie County,Texas,19720,1178,1049,4978,4037,1530,4346,2602,17493,6948
48173,Glasscock County,Texas,739,73,30,121,217,19,217,62,636,279
48175,Goliad County,Texas,5044,448,336,1563,1247,550,660,240,4260,900
48177,Gonzales County,Texas,12754,1190,1692,5537,1916,750,1168,501,9872,1669
48179,Gray County,Texas,14061,1207,1384,4547,3433,1236,1726,528,11470,2254
48181,Grayson County,Texas,92530,3591,5274,27905,24509,10136,14097,7018,83665,21115
48183,Gregg County,Texas,80126,4562,6312,22991,21213,7081,12208,5759,69252,17967
48185,Grimes County,Texas,20175,1421,2456,6303,4662,1414,2418,1501,16298,3919
48187,Guadalupe County,Texas,115577,5196,7412,34105,24056,10667,22664,11477,102969,34141
48189,Hale County,Texas,19888,2751,2263,6562,4008,1360,1827,1117,14874,2944
48191,Hall County,Texas,1978,132,228,664,373,221,277,83,1618,360
48193,Hamilton County,Texas,5812,235,386,2085,1145,505,1040,416,5191,1456
48195,Hansford County,Texas,3276,413,499,731,496,168,812,157,2364,969
48197,Hardeman County,Texas,2473,127,245,847,623,200,326,105,2101,431
48199,Hardin County,Texas,38319,1162,3107,14801,8910,3262,5413,1664,34050,7077
48201,Harris County,Texas,3032681,314460,227020,694818,576643,213891,629798,376051,2491201,1005849
48203,Harrison County,Texas,45553,1563,3298,14935,11745,3900,6889,3223,40692,10112
48205,Hartley County,Texas,4062,316,327,1429,727,236,591,436,3419,1027
48207,Haskell County,Texas,3963,327,484,1425,723,205,472,327,3152,799
48209,Hays County,Texas,149815,6565,7104,33339,32493,9844,39393,21077,136146,60470
48211,Hemphill County,Texas,2262,161,96,801,470,207,410,117,2005,527
48213,Henderson County,Texas,58449,2697,5103,19761,14936,4817,7663,3472,50649,11135
48215,Hidalgo County,Texas,496398,91148,64779,123312,91055,26214,69445,30445,340471,99890
48217,Hill County,Texas,24820,1407,2166,8495,5889,2517,2974,1372,21247,4346
48219,Hockley County,Texas,13638,1334,1455,3926,3270,1309,1544,800,10849,2344
48221,Hood County,Texas,45404,1215,2250,12709,11426,3433,9707,4664,41939,14371
48223,Hopkins County,Texas,24949,1367,2400,8612,5364,1818,3704,1684,21182,5388
48225,Houston County,Texas,16318,982,1892,6391,3447,1195,1719,692,13444,2411
48227,Howard County,Texas,23829,1928,2596,8261,5969,1783,2233,1059,19305,3292
48229,Hudspeth County,Texas,2242,625,386,567,340,92,212,20,1231,232
48231,Hunt County,Texas,67094,2643,5625,23560,16074,4880,9796,4516,58826,14312
48233,Hutchinson County,Texas,13527,730,1178,4466,3716,1326,1537,574,11619,2111
48235,Irion County,Texas,1127,75,51,272,411,111,183,24,1001,207
48237,Jack County,Texas,5841,385,804,1921,1418,405,678,230,4652,908
48239,Jackson County,Texas,10059,928,1025,3484,2507,804,1060,251,8106,1311
48241,Jasper County,Texas,22805,787,2114,10773,4720,1620,1927,864,19904,2791
48243,Jeff Davis County,Texas,1634,158,75,316,492,138,204,251,1401,455
48245,Jefferson County,Texas,170001,12486,13438,53944,40524,15767,23546,10296,144077,33842
48247,Jim Hogg County,Texas,2439,223,299,1041,517,48,209,102,1917,311
48249,Jim Wells County,Texas,24864,2147,3257,9087,5081,1497,2994,801,19460,3795
48251,Johnson County,Texas,119361,5806,10457,41285,27354,8937,17706,7816,103098,25522
48253,Jones County,Texas,14653,812,2001,5668,3354,1183,1284,351,11840,1635
48255,Karnes County,Texas,10347,921,1556,3827,1738,621,1184,500,7870,1684
48257,Kaufman County,Texas,94837,4973,7975,27613,23280,8455,16082,6459,81889,22541
48259,Kendall County,Texas,31578,1288,1085,4868,6689,2329,9746,5573,29205,15319
48261,Kenedy County,Texas,87,41,17,19,3,0,5,2,29,7
48263,Kent County,Texas,452,21,31,131,121,22,64,62,400,126
48265,Kerr County,Texas,38482,1655,2313,11064,9082,2911,7081,4376,34514,11457
48267,Kimble County,Texas,3177,170,298,885,795,144,602,283,2709,885
48269,King County,Texas,160,29,5,53,24,0,41,8,126,49
48271,Kinney County,Texas,2536,217,173,622,1004,183,174,163,2146,337
48273,Kleberg County,Texas,17217,1620,1413,5971,3364,896,2560,1393,14184,3953
48275,Knox County,Texas,2310,229,191,764,601,198,195,132,1890,327
48277,Lamar County,Texas,34191,1794,2469,11527,7921,3337,4736,2407,29928,7143
48279,Lamb County,Texas,8225,1061,859,3037,1585,624,804,255,6305,1059
48281,Lampasas County,Texas,15447,679,822,4697,4381,1750,2183,935,13946,3118
48283,La Salle County,Texas,4483,622,1063,1955,497,103,144,99,2798,243
48285,Lavaca County,Texas,14057,1145,918,5294,2911,1040,1940,809,11994,2749
48287,Lee County,Texas,12387,776,897,4865,2882,912,1456,599,10714,2055
48289,Leon County,Texas,11219,712,1018,4351,2804,650,1180,504,9489,1684
48291,Liberty County,Texas,58795,5635,7062,23131,12893,3865,4551,1658,46098,6209
48293,Limestone County,Texas,15524,1007,1385,5394,3749,1372,1865,752,13132,2617
48295,Lipscomb County,Texas,1872,160,119,588,409,133,378,85,1593,463
48297,Live Oak County,Texas,8273,841,1191,2486,2237,396,630,492,6241,1122
48299,Llano County,Texas,17083,410,1037,4542,4433,1227,3794,1640,15636,5434
48301,Loving County,Texas,63,0,2,10,19,32,0,0,61,0
48303,Lubbock County,Texas,184975,9077,12492,46961,41766,14333,36968,23378,163406,60346
48305,Lynn County,Texas,3668,296,386,1054,739,292,630,271,2986,901
48307,McCulloch County,Texas,5385,527,556,1695,1314,294,685,314,4302,999
48309,McLennan County,Texas,159035,8155,12638,42852,36275,16269,26129,16717,138242,42846
48311,McMullen County,Texas,432,20,28,195,88,33,51,17,384,68
48313,Madison County,Texas,9295,458,1502,3489,1989,552,947,358,7335,1305
48315,Marion County,Texas,7233,263,696,2927,1564,607,977,199,6274,1176
48317,Martin County,Texas,3019,299,178,1215,754,63,294,216,2542,510
48319,Mason County,Texas,2769,184,234,595,575,129,722,330,2351,1052
48321,Matagorda County,Texas,23788,2366,2040,6760,5709,1953,3322,1638,19382,4960
48323,Maverick County,Texas,33187,6555,5185,8773,5465,1958,3846,1405,21447,5251
48325,Medina County,Texas,34739,1956,2900,11342,7715,3120,4622,3084,29883,7706
48327,Menard County,Texas,1525,135,202,394,306,124,228,136,1188,364
48329,Midland County,Texas,105464,7914,8544,24457,25069,8424,21716,9340,89006,31056
48331,Milam County,Texas,17084,1181,1245,6665,3608,1269,2148,968,14658,3116
48333,Mills County,Texas,3395,182,229,1065,731,222,629,337,2984,966
48335,Mitchell County,Texas,5459,382,502,2237,1507,307,392,132,4575,524
48337,Montague County,Texas,14199,661,1044,5474,3492,1154,1823,551,12494,2374
48339,Montgomery County,Texas,412475,17842,24198,94566,88477,31714,102960,52718,370435,155678
48341,Moore County,Texas,12547,2685,1338,3905,2191,942,994,492,8524,1486
48343,Morris County,Texas,8137,360,650,3228,2230,567,640,462,7127,1102
48345,Motley County,Texas,921,41,88,287,251,66,140,48,792,188
48347,Nacogdoches County,Texas,37715,2778,2817,11068,9254,2234,6015,3549,32120,9564
48349,Navarro County,Texas,33975,3376,3271,10279,8295,2977,3882,1895,27328,5777
48351,Newton County,Texas,8735,396,1183,3996,1982,585,424,169,7156,593
48353,Nolan County,Texas,9530,653,884,3293,2419,951,872,458,7993,1330
48355,Nueces County,Texas,231734,15272,20665,67626,55036,21017,33323,18795,195797,52118
48357,Ochiltree County,Texas,6078,752,688,2039,1152,319,747,381,4638,1128
48359,Oldham County,Texas,1302,122,93,351,285,140,224,87,1087,311
48361,Orange County,Texas,56679,1407,4649,20272,14032,6591,7267,2461,50623,9728
48363,Palo Pinto County,Texas,19471,988,1445,7631,4388,1502,2326,1191,17038,3517
48365,Panola County,Texas,15292,692,1798,4455,4468,1409,1796,674,12802,2470
48367,Parker County,Texas,102048,3516,6407,27449,22971,10192,20626,10887,92125,31513
48369,Parmer County,Texas,6233,1186,618,1555,1153,571,856,294,4429,1150
48371,Pecos County,Texas,10286,1060,1418,3770,2323,535,714,466,7808,1180
48373,Polk County,Texas,36530,2487,4319,13608,9016,2283,3197,1620,29724,4817
48375,Potter County,Texas,75078,8391,8750,23200,16262,5736,8904,3835,57937,12739
48377,Presidio County,Texas,3794,1200,256,669,547,317,568,237,2338,805
48379,Rains County,Texas,9191,526,633,3304,2275,569,1341,543,8032,1884
48381,Randall County,Texas,93239,2051,3683,21795,25820,9392,20217,10281,87505,30498
48383,Reagan County,Texas,1986,29,207,1049,341,122,144,94,1750,238
48385,Real County,Texas,1967,141,74,726,524,90,316,96,1752,412
48387,Red River County,Texas,8469,455,805,3391,2051,584,786,397,7209,1183
48389,Reeves County,Texas,9135,1253,1415,3304,1660,604,712,187,6467,899
48391,Refugio County,Texas,4703,273,487,2057,1060,299,384,143,3943,527
48393,Roberts County,Texas,536,0,44,202,116,71,76,27,492,103
48395,Robertson County,Texas,11556,604,1097,4437,2329,965,1458,666,9855,2124
48397,Rockwall County,Texas,72042,1771,2304,13353,16224,6786,20110,11494,67967,31604
48399,Runnels County,Texas,6840,628,542,2449,1512,456,889,364,5670,1253
48401,Rusk County,Texas,36101,1804,3917,11897,9356,3411,3771,1945,30380,5716
48403,Sabine County,Texas,7611,319,677,2709,1849,696,724,637,6615,1361
48405,San Augustine County,Texas,5847,284,750,2636,1225,205,437,310,4813,747
48407,San Jacinto County,Texas,19564,1134,1691,7762,4742,1105,1746,1384,16739,3130
48409,San Patricio County,Texas,44640,3674,4229,14810,10636,3433,5325,2533,36737,7858
48411,San Saba County,Texas,4116,255,329,1624,931,177,577,223,3532,800
48413,Schleicher County,Texas,1655,162,136,491,541,100,163,62,1357,225
48415,Scurry County,Texas,11030,867,850,3632,2722,912,1492,555,9313,2047
48417,Shackelford County,Texas,2148,11,128,512,631,170,565,131,2009,696
48419,Shelby County,Texas,15896,1311,1600,5866,4013,907,1587,612,12985,2199
48421,Sherman County,Texas,1579,216,225,366,340,88,264,80,1138,344
48423,Smith County,Texas,154691,8441,10749,38459,38821,15869,28037,14315,135501,42352
48425,Somervell County,Texas,6560,148,320,2106,1707,403,1400,476,6092,1876
48427,Starr County,Texas,36496,9495,4786,9707,6233,1628,3343,1304,22215,4647
48429,Stephens County,Texas,6350,423,639,2200,1518,401,884,285,5288,1169
48431,Sterling County,Texas,820,19,62,345,176,26,120,72,739,192
48433,Stonewall County,Texas,769,69,78,339,155,12,57,59,622,116
48435,Sutton County,Texas,1975,201,194,734,469,74,157,146,1580,303
48437,Swisher County,Texas,4529,614,387,1550,723,381,712,162,3528,874
48439,Tarrant County,Texas,1365169,83452,93206,325401,292806,107369,305663,157272,1188511,462935
48441,Taylor County,Texas,87176,3377,5350,25754,19851,7850,16025,8969,78449,24994
48443,Terrell County,Texas,718,16,29,284,156,21,143,69,673,212
48445,Terry County,Texas,7356,1084,682,2485,1833,461,595,216,5590,811
48447,Throckmorton County,Texas,1064,66,38,414,267,64,161,54,960,215
48449,Titus County,Texas,19428,2457,1897,7254,3353,1485,2095,887,15074,2982
48451,Tom Green County,Texas,77310,4755,5569,21959,20271,5704,12655,6397,66986,19052
48453,Travis County,Texas,901585,48039,34695,134901,148599,50383,301552,183416,818851,484968
48455,Trinity County,Texas,9979,524,831,3883,2597,663,1130,351,8624,1481
48457,Tyler County,Texas,14458,837,1681,6021,3313,711,1256,639,11940,1895
48459,Upshur County,Texas,28275,1205,2597,9348,7523,2788,3463,1351,24473,4814
48461,Upton County,Texas,2195,253,209,962,414,145,148,64,1733,212
48463,Uvalde County,Texas,15486,1915,1780,4202,3289,1344,2200,756,11791,2956
48465,Val Verde County,Texas,28847,4643,2990,7907,5006,2464,3516,2321,21214,5837
48467,Van Zandt County,Texas,41750,1750,4082,13897,11445,3446,5096,2034,35918,7130
48469,Victoria County,Texas,59744,3998,5658,18090,14714,5815,8322,3147,50088,11469
48471,Walker County,Texas,51244,3032,4504,19589,10864,3354,6420,3481,43708,9901
48473,Waller County,Texas,31707,2115,2103,9918,8132,1552,5807,2080,27489,7887
48475,Ward County,Texas,7184,729,692,2706,1831,411,621,194,5763,815
48477,Washington County,Texas,24195,994,1492,7627,5257,1844,4631,2350,21709,6981
48479,Webb County,Texas,150530,23908,22566,32953,28341,11778,22081,8903,104056,30984
48481,Wharton County,Texas,27211,2296,2796,8469,5886,2837,3508,1419,22119,4927
48483,Wheeler County,Texas,3452,237,253,1369,808,189,502,94,2962,596
48485,Wichita County,Texas,83476,4555,5838,26535,19657,6968,12624,7299,73083,19923
48487,Wilbarger County,Texas,8703,755,1121,2888,1973,518,1101,347,6827,1448
48489,Willacy County,Texas,12926,2205,1998,4784,1893,691,994,361,8723,1355
48491,Williamson County,Texas,414552,11511,12919,75113,86188,36949,123988,67884,390122,191872
48493,Wilson County,Texas,34277,1622,1548,11192,8105,3106,6216,2488,31107,8704
48495,Winkler County,Texas,4675,583,704,1697,988,278,350,75,3388,425
48497,Wise County,Texas,47242,2689,3443,16017,11571,3693,7054,2775,41110,9829
48499,Wood County,Texas,32972,1762,2823,10455,8666,2298,4216,2752,28387,6968
48501,Yoakum County,Texas,4596,882,566,1293,1176,234,394,51,3148,445
48503,Young County,Texas,12426,641,837,4077,3073,997,2002,799,10948,2801
48505,Zapata County,Texas,7912,1557,1166,2342,1458,491,722,176,5189,898
48507,Zavala County,Texas,5822,959,639,1639,1272,512,588,213,4224,801
49001,Beaver County,Utah,4241,134,193,1164,1000,582,924,244,3914,1168
49003,Box Elder County,Utah,34857,741,1552,11223,9056,3279,6499,2507,32564,9006
49005,Cache County,Utah,68799,1679,2341,13805,18184,5302,17456,10032,64779,27488
49007,Carbon County,Utah,13286,319,745,3888,3974,2137,1563,660,12222,2223
49009,Daggett County,Utah,429,3,28,126,157,37,53,25,398,78
49011,Davis County,Utah,215372,3064,6158,45745,54902,22855,54957,27691,206150,82648
49013,Duchesne County,Utah,11720,253,1016,4600,3100,1066,1152,533,10451,1685
49015,Emery County,Utah,6282,132,288,1953,1894,1035,572,408,5862,980
49017,Garfield County,Utah,3747,52,100,1090,918,451,785,351,3595,1136
49019,Grand County,Utah,6970,132,252,1612,1999,764,1501,710,6586,2211
49021,Iron County,Utah,32559,643,1632,7769,9008,3616,6623,3268,30284,9891
49023,Juab County,Utah,6736,89,344,2294,1819,749,989,452,6303,1441
49025,Kane County,Utah,5607,83,232,1481,1443,552,1238,578,5292,1816
49027,Millard County,Utah,7915,256,492,2570,1933,800,1428,436,7167,1864
49029,Morgan County,Utah,6940,45,79,1591,1811,806,1667,941,6816,2608
49031,Piute County,Utah,1234,57,80,427,292,136,171,71,1097,242
49033,Rich County,Utah,1528,29,35,326,537,191,250,160,1464,410
49035,Salt Lake County,Utah,754424,25107,36846,168538,170263,69300,182997,101373,692471,284370
49037,San Juan County,Utah,8909,533,554,2764,2443,917,1153,545,7822,1698
49039,Sanpete County,Utah,17341,652,1116,5415,4392,1895,2294,1577,15573,3871
49041,Sevier County,Utah,13611,373,718,4271,3582,1560,2083,1024,12520,3107
49043,Summit County,Utah,28806,474,667,4377,5267,1474,10326,6221,27665,16547
49045,Tooele County,Utah,43518,927,2293,13831,11734,4905,6423,3405,40298,9828
49047,Uintah County,Utah,21267,284,2118,7267,5775,2000,2856,967,18865,3823
49049,Utah County,Utah,335378,5964,9937,56440,85308,34099,99898,43732,319477,143630
49051,Wasatch County,Utah,21373,551,409,4049,4430,1958,6585,3391,20413,9976
49053,Washington County,Utah,120527,2095,4665,25378,32959,15940,24819,14671,113767,39490
49055,Wayne County,Utah,1753,10,111,414,514,314,269,121,1632,390
49057,Weber County,Utah,164790,4328,8453,47965,43319,16213,31010,13502,152009,44512
50001,Addison County,Vermont,26081,359,1086,7601,4124,1998,6343,4570,24636,10913
50003,Bennington County,Vermont,26835,509,1067,7543,4932,2211,5734,4839,25259,10573
50005,Caledonia County,Vermont,21985,415,960,7312,4702,1669,4219,2708,20610,6927
50007,Chittenden County,Vermont,112289,1852,3456,18846,15902,9693,36064,26476,106981,62540
50009,Essex County,Vermont,4562,122,385,1968,819,348,515,405,4055,920
50011,Franklin County,Vermont,35303,1037,1819,13229,6064,3478,6192,3484,32447,9676
50013,Grand Isle County,Vermont,5608,55,166,1779,756,463,1406,983,5387,2389
50015,Lamoille County,Vermont,18510,241,830,4255,3703,1559,5040,2882,17439,7922
50017,Orange County,Vermont,21890,397,930,7304,3121,2427,4186,3525,20563,7711
50019,Orleans County,Vermont,20080,607,1093,7554,3342,1915,3474,2095,18380,5569
50021,Rutland County,Vermont,44836,809,2070,15185,7686,4272,8964,5850,41957,14814
50023,Washington County,Vermont,43551,716,1414,11213,6991,3107,11793,8317,41421,20110
50025,Windham County,Vermont,34055,357,1617,10333,5604,2387,7225,6532,32081,13757
50027,Windsor County,Vermont,43448,663,1555,12575,7129,3817,10459,7250,41230,17709
51001,Accomack County,Virginia,24396,1593,2904,8062,4578,2051,2970,2238,19899,5208
51003,Albemarle County,Virginia,76936,1799,2951,11279,10211,4434,23136,23126,72186,46262
51005,Alleghany County,Virginia,11161,384,935,4845,2469,827,967,734,9842,1701
51007,Amelia County,Virginia,9801,512,822,4443,1517,770,1251,486,8467,1737
51009,Amherst County,Virginia,22321,952,1790,8460,4045,2195,2996,1883,19579,4879
51011,Appomattox County,Virginia,11491,433,726,4558,2706,853,1626,589,10332,2215
51013,Arlington County,Virginia,173124,5180,2933,12636,13828,5657,61741,71149,165011,132890
51015,Augusta County,Virginia,57106,2088,3698,22987,10820,4232,8937,4344,51320,13281
51017,Bath County,Virginia,3217,208,241,1179,773,226,408,182,2768,590
51019,Bedford County,Virginia,58099,1480,2928,17066,12470,5240,11560,7355,53691,18915
51021,Bland County,Virginia,4995,104,298,2271,1105,397,565,255,4593,820
51023,Botetourt County,Virginia,24891,611,984,8744,4683,2986,4273,2610,23296,6883
51025,Brunswick County,Virginia,12066,797,2036,4162,2318,817,1194,742,9233,1936
51027,Buchanan County,Virginia,15445,1577,2401,6082,2612,1084,853,836,11467,1689
51029,Buckingham County,Virginia,12595,844,1155,5709,2566,790,985,546,10596,1531
51031,Campbell County,Virginia,40012,1383,2426,13716,9009,3616,6576,3286,36203,9862
51033,Caroline County,Virginia,21511,591,1699,8606,4162,1654,2961,1838,19221,4799
51035,Carroll County,Virginia,21867,1495,2219,8331,3881,2464,2474,1003,18153,3477
51036,Charles City County,Virginia,5323,186,617,2132,1112,414,628,234,4520,862
51037,Charlotte County,Virginia,8154,369,896,3102,1609,822,789,567,6889,1356
51041,Chesterfield County,Virginia,247120,7726,10513,54991,48040,21266,64038,40546,228881,104584
51043,Clarke County,Virginia,10904,194,492,3214,2352,891,2420,1341,10218,3761
51045,Craig County,Virginia,3476,99,321,1451,667,383,378,177,3056,555
51047,Culpeper County,Virginia,35453,1294,2471,12056,6892,3222,6226,3292,31688,9518
51049,Cumberland County,Virginia,7215,422,581,2502,1593,780,705,632,6212,1337
51051,Dickenson County,Virginia,10379,744,1190,4083,2201,975,970,216,8445,1186
51053,Dinwiddie County,Virginia,20159,705,1403,7960,4216,2276,2227,1372,18051,3599
51057,Essex County,Virginia,7710,446,895,2801,1999,388,779,402,6369,1181
51059,Fairfax County,Virginia,782543,27679,23156,95159,91469,43431,248678,252971,731708,501649
51061,Fauquier County,Virginia,50357,1467,2442,12256,10887,3451,12142,7712,46448,19854
51063,Floyd County,Virginia,11686,420,650,4442,2018,1445,1588,1123,10616,2711
51065,Fluvanna County,Virginia,20240,337,1022,5065,4859,1713,4547,2697,18881,7244
51067,Franklin County,Virginia,39873,1474,2639,13766,8566,3920,6109,3399,35760,9508
51069,Frederick County,Virginia,64068,2726,4523,20000,13360,4821,10918,7720,56819,18638
51071,Giles County,Virginia,12132,401,763,4948,2661,1023,1376,960,10968,2336
51073,Gloucester County,Virginia,28272,734,2109,8591,7026,2603,4511,2698,25429,7209
51075,Goochland County,Virginia,18847,379,713,4375,3549,1456,4704,3671,17755,8375
51077,Grayson County,Virginia,11769,678,1318,4653,1993,1467,1216,444,9773,1660
51079,Greene County,Virginia,14314,436,1093,4630,2921,1242,2476,1516,12785,3992
51081,Greensville County,Virginia,8609,684,1064,3379,1716,610,751,405,6861,1156
51083,Halifax County,Virginia,24647,1797,2601,8890,4801,2347,2798,1413,20249,4211
51085,Hanover County,Virginia,76949,1532,2776,18734,15289,6421,20372,11825,72641,32197
51087,Henrico County,Virginia,232800,6296,10273,50538,44194,15842,62157,43500,216231,105657
51089,Henry County,Virginia,37373,2834,4163,13471,7374,4151,3474,1906,30376,5380
51091,Highland County,Virginia,1716,72,99,644,305,70,346,180,1545,526
51093,Isle of Wight County,Virginia,27889,565,1893,8028,6347,2750,4938,3368,25431,8306
51095,James City County,Virginia,57505,842,1605,11090,10142,5064,15086,13676,55058,28762
51097,King and Queen County,Virginia,5203,151,555,1721,1130,472,873,301,4497,1174
51099,King George County,Virginia,17979,649,1091,4968,3680,1324,3694,2573,16239,6267
51101,King William County,Virginia,12367,132,673,4343,3176,975,2299,769,11562,3068
51103,Lancaster County,Virginia,8739,335,857,2522,1478,724,1598,1225,7547,2823
51105,Lee County,Virginia,16643,1397,1641,6102,4366,1220,1408,509,13605,1917
51107,Loudoun County,Virginia,272771,7572,7815,30888,36761,16514,97356,75865,257384,173221
51109,Louisa County,Virginia,27905,1124,2044,9422,5976,2130,4102,3107,24737,7209
51111,Lunenburg County,Virginia,8799,692,1178,3207,2118,627,654,323,6929,977
51113,Madison County,Virginia,10115,366,948,3525,2081,717,1288,1190,8801,2478
51115,Mathews County,Virginia,6472,32,340,2032,1520,619,1402,527,6100,1929
51117,Mecklenburg County,Virginia,22650,1210,1852,7763,4627,2335,2959,1904,19588,4863
51119,Middlesex County,Virginia,8382,272,617,2397,1909,707,1679,801,7493,2480
51121,Montgomery County,Virginia,55915,867,1937,13187,9977,3937,12154,13856,53111,26010
51125,Nelson County,Virginia,11116,387,1103,3905,1655,683,2024,1359,9626,3383
51127,New Kent County,Virginia,17446,185,837,5118,3856,1587,4110,1753,16424,5863
51131,Northampton County,Virginia,9104,538,656,2821,1751,667,1593,1078,7910,2671
51133,Northumberland County,Virginia,9305,384,621,2599,1797,765,1757,1382,8300,3139
51135,Nottoway County,Virginia,11219,640,1183,4429,2300,866,1308,493,9396,1801
51137,Orange County,Virginia,26211,916,1762,9270,5196,1911,4377,2779,23533,7156
51139,Page County,Virginia,17364,1023,2030,7906,2877,976,1419,1133,14311,2552
51141,Patrick County,Virginia,13562,1033,1185,4884,2752,1500,1530,678,11344,2208
51143,Pittsylvania County,Virginia,44958,2462,4637,17109,9712,4300,4666,2072,37859,6738
51145,Powhatan County,Virginia,22976,459,1485,6339,5009,2158,5397,2129,21032,7526
51147,Prince Edward County,Virginia,12652,590,875,4467,2595,721,2077,1327,11187,3404
51149,Prince George County,Virginia,27630,858,2076,8510,6787,2742,4623,2034,24696,6657
51153,Prince William County,Virginia,308899,17561,13491,61565,56980,24395,79259,55648,277847,134907
51155,Pulaski County,Virginia,25456,848,1614,8735,6272,2605,3222,2160,22994,5382
51157,Rappahannock County,Virginia,5568,201,324,1658,1100,402,1030,853,5043,1883
51159,Richmond County,Virginia,6785,583,1109,2392,852,640,770,439,5093,1209
51161,Roanoke County,Virginia,69897,1834,2848,18924,13397,6662,16855,9377,65215,26232
51163,Rockbridge County,Virginia,17030,611,988,5834,3398,1062,2660,2477,15431,5137
51165,Rockingham County,Virginia,57436,2960,4404,20886,8817,3813,9785,6771,50072,16556
51167,Russell County,Virginia,19105,1656,1604,7791,3672,1984,1641,757,15845,2398
51169,Scott County,Virginia,16157,1315,1434,5945,3513,1707,1470,773,13408,2243
51171,Shenandoah County,Virginia,31621,1247,2368,12778,5925,2762,3848,2693,28006,6541
51173,Smyth County,Virginia,21792,1086,2248,8390,3946,2319,2431,1372,18458,3803
51175,Southampton County,Virginia,13236,567,1183,4365,3505,1106,1701,809,11486,2510
51177,Spotsylvania County,Virginia,94502,3089,5390,26184,21137,7241,18959,12502,86023,31461
51179,Stafford County,Virginia,101532,3152,4060,22375,20260,7951,26284,17450,94320,43734
51181,Surry County,Virginia,4969,156,459,1619,1232,335,871,297,4354,1168
51183,Sussex County,Virginia,7976,316,1172,3010,1675,575,779,449,6488,1228
51185,Tazewell County,Virginia,29102,1692,2279,11318,6107,3067,3126,1513,25131,4639
51187,Warren County,Virginia,28642,1126,2070,9846,6993,2184,4225,2198,25446,6423
51191,Washington County,Virginia,40259,1656,2673,14412,7618,4010,6328,3562,35930,9890
51193,Westmoreland County,Virginia,13910,983,1541,5572,2405,955,1385,1069,11386,2454
51195,Wise County,Virginia,25997,1805,3301,8974,5150,2537,2532,1698,20891,4230
51197,Wythe County,Virginia,20773,605,1444,7425,4759,2365,2502,1673,18724,4175
51199,York County,Virginia,47433,857,1357,8130,8835,4780,12821,10653,45219,23474
51510,Alexandria city,Virginia,119669,4199,3358,12536,14392,6202,37901,41081,112112,78982
51520,Bristol city,Virginia,12294,325,1369,3762,3042,992,1447,1357,10600,2804
51530,Buena Vista city,Virginia,4024,224,530,1314,784,308,528,336,3270,864
51540,Charlottesville city,Virginia,29416,908,1451,4621,3627,1470,8241,9098,27057,17339
51550,Chesapeake city,Virginia,168224,4203,7042,39473,40357,16989,37311,22849,156979,60160
51570,Colonial Heights city,Virginia,12713,534,551,3939,2878,1241,2148,1422,11628,3570
51580,Covington city,Virginia,3991,102,352,1917,882,283,296,159,3537,455
51590,Danville city,Virginia,29469,1425,3165,11311,5438,2634,3421,2075,24879,5496
51595,Emporia city,Virginia,3819,319,563,1344,595,369,367,262,2937,629
51600,Fairfax city,Virginia,16324,598,670,2307,1978,968,5065,4738,15056,9803
51610,Falls Church city,Virginia,9712,148,104,692,898,210,2969,4691,9460,7660
51620,Franklin city,Virginia,5659,224,667,1834,1150,472,737,575,4768,1312
51630,Fredericksburg city,Virginia,16897,641,619,3634,3814,843,4208,3138,15637,7346
51640,Galax city,Virginia,4432,324,552,1138,1167,477,453,321,3556,774
51650,Hampton city,Virginia,92527,2200,4506,27045,22864,10310,15565,10037,85821,25602
51660,Harrisonburg city,Virginia,26275,2427,1879,6764,3846,2112,5194,4053,21969,9247
51670,Hopewell city,Virginia,15006,684,1287,6320,3665,1384,1097,569,13035,1666
51678,Lexington city,Virginia,3367,51,77,766,292,153,1040,988,3239,2028
51680,Lynchburg city,Virginia,44182,1408,2870,10527,9178,3417,10012,6770,39904,16782
51683,Manassas city,Virginia,27688,2194,1729,8017,4214,1971,6081,3482,23765,9563
51685,Manassas Park city,Virginia,11381,1421,842,3596,1905,770,1941,906,9118,2847
51690,Martinsville city,Virginia,8927,495,712,2806,1713,1389,1137,675,7720,1812
51700,Newport News city,Virginia,120199,3497,6453,35520,27758,12501,21039,13431,110249,34470
51710,Norfolk city,Virginia,152314,4870,11499,37165,36892,12893,29179,19816,135945,48995
51720,Norton city,Virginia,2684,99,165,935,720,245,293,227,2420,520
51730,Petersburg city,Virginia,22903,1203,1904,8220,4786,1806,3094,1890,19796,4984
51735,Poquoson city,Virginia,8747,122,214,2391,1828,829,1809,1554,8411,3363
51740,Portsmouth city,Virginia,65575,1629,5245,20982,17591,6195,8863,5070,58701,13933
51750,Radford city,Virginia,7321,214,274,1343,1693,519,1565,1713,6833,3278
51760,Richmond city,Virginia,160905,7134,10944,33122,30058,8648,41357,29642,142827,70999
51770,Roanoke city,Virginia,69643,2350,5228,23982,13188,5109,12316,7470,62065,19786
51775,Salem city,Virginia,17311,360,692,4685,3682,2262,3331,2299,16259,5630
51790,Staunton city,Virginia,18357,384,976,5592,3992,1252,3406,2755,16997,6161
51800,Suffolk city,Virginia,64647,2131,3574,17052,15343,5807,12702,8038,58942,20740
51810,Virginia Beach city,Virginia,316178,5820,11524,65598,73985,33461,78171,47619,298834,125790
51820,Waynesboro city,Virginia,15799,729,1138,5520,2916,1196,2595,1705,13932,4300
51830,Williamsburg city,Virginia,7688,183,334,1243,1288,749,2068,1823,7171,3891
51840,Winchester city,Virginia,18799,1026,1418,5222,3809,1259,3562,2503,16355,6065
53001,Adams County,Washington,11258,2448,821,3527,2057,748,1018,639,7989,1657
53003,Asotin County,Washington,16165,249,881,5066,4135,2100,2321,1413,15035,3734
53005,Benton County,Washington,134954,6917,6445,31381,32007,14562,26629,17013,121592,43642
53007,Chelan County,Washington,54434,4424,3522,13438,11533,5441,10471,5605,46488,16076
53009,Clallam County,Washington,59865,1254,2965,14509,15733,6952,10921,7531,55646,18452
53011,Clark County,Washington,345411,8096,16221,86080,86583,37244,70887,40300,321094,111187
53013,Columbia County,Washington,3021,97,209,608,887,415,483,322,2715,805
53015,Cowlitz County,Washington,77072,2547,5109,24528,22290,9809,8679,4110,69416,12789
53017,Douglas County,Washington,28706,2864,2364,7933,6658,2650,4466,1771,23478,6237
53019,Ferry County,Washington,5559,118,359,1771,1613,691,644,363,5082,1007
53021,Franklin County,Washington,56267,8363,5227,14608,11631,5163,6915,4360,42677,11275
53023,Garfield County,Washington,1696,28,93,415,461,241,269,189,1575,458
53025,Grant County,Washington,60723,6654,5230,17326,14657,6127,7832,2897,48839,10729
53027,Grays Harbor County,Washington,55194,1905,3584,19482,14217,6525,6104,3377,49705,9481
53029,Island County,Washington,63659,804,1961,13752,17162,7470,13324,9186,60894,22510
53031,Jefferson County,Washington,27822,164,656,5729,6843,2339,6616,5475,27002,12091
53033,King County,Washington,1622636,51587,49162,238296,267988,125654,519110,370839,1521887,889949
53035,Kitsap County,Washington,194382,2872,6372,41545,51947,22972,44914,23760,185138,68674
53037,Kittitas County,Washington,28306,446,1496,7507,6477,2174,6515,3691,26364,10206
53039,Klickitat County,Washington,17119,685,1124,4568,3754,1717,2950,2321,15310,5271
53041,Lewis County,Washington,58732,2038,4132,17827,15978,7153,7495,4109,52562,11604
53043,Lincoln County,Washington,7879,135,460,2117,2375,979,1207,606,7284,1813
53045,Mason County,Washington,48525,1309,3297,14674,12770,6070,6510,3895,43919,10405
53047,Okanogan County,Washington,29871,2044,2134,8854,6843,3232,4140,2624,25693,6764
53049,Pacific County,Washington,18446,594,1010,5450,5268,1750,3112,1262,16842,4374
53051,Pend Oreille County,Washington,9958,140,514,3195,2858,1111,1409,731,9304,2140
53053,Pierce County,Washington,622204,16112,31435,163980,155802,72468,117242,65165,574657,182407
53055,San Juan County,Washington,14820,195,428,2359,3057,986,4463,3332,14197,7795
53057,Skagit County,Washington,92028,3325,5158,23624,23355,10178,16556,9832,83545,26388
53059,Skamania County,Washington,9148,126,476,2865,2452,818,1457,954,8546,2411
53061,Snohomish County,Washington,580338,15966,25902,132885,138201,62145,135876,69363,538470,205239
53063,Spokane County,Washington,371538,7201,14635,86854,95998,48216,76236,42398,349702,118634
53065,Stevens County,Washington,33841,581,2112,11357,8846,3857,4341,2747,31148,7088
53067,Thurston County,Washington,208615,3787,8113,45825,51537,23407,47084,28862,196715,75946
53069,Wahkiakum County,Washington,3451,136,138,966,954,493,506,258,3177,764
53071,Walla Walla County,Washington,40947,1868,2662,8957,10390,4838,6937,5295,36417,12232
53073,Whatcom County,Washington,152506,3271,6941,33470,35981,16392,34017,22434,142294,56451
53075,Whitman County,Washington,24342,295,725,3471,5028,2431,6581,5811,23322,12392
53077,Yakima County,Washington,155876,21687,16244,44331,31674,13574,18200,10166,117945,28366
54001,Barbour County,West Virginia,10601,383,899,5720,1662,689,729,519,9319,1248
54003,Berkeley County,West Virginia,85192,2540,5506,30966,17648,7814,13653,7065,77146,20718
54005,Boone County,West Virginia,15480,807,1602,7360,2490,1415,990,816,13071,1806
54007,Braxton County,West Virginia,9292,576,1044,4829,1377,375,801,290,7672,1091
54009,Brooke County,West Virginia,16252,316,902,6874,3052,1549,2242,1317,15034,3559
54011,Cabell County,West Virginia,62754,1977,4424,19577,12400,5360,10541,8475,56353,19016
54013,Calhoun County,West Virginia,4718,237,387,2593,917,191,245,148,4094,393
54015,Clay County,West Virginia,5609,398,537,2922,669,376,366,341,4674,707
54017,Doddridge County,West Virginia,6056,312,779,2676,1061,501,549,178,4965,727
54019,Fayette County,West Virginia,29452,1398,3031,13127,5019,2225,3175,1477,25023,4652
54021,Gilmer County,West Virginia,5288,248,653,2502,600,216,624,445,4387,1069
54023,Grant County,West Virginia,8164,436,568,4308,1328,445,681,398,7160,1079
54025,Greenbrier County,West Virginia,24403,903,1998,9971,4389,2043,2975,2124,21502,5099
54027,Hampshire County,West Virginia,17297,705,1415,8137,3224,1298,1681,837,15177,2518
54029,Hancock County,West Virginia,21485,690,1358,8508,4262,2565,2859,1243,19437,4102
54031,Hardy County,West Virginia,10431,496,915,4953,1750,763,782,772,9020,1554
54033,Harrison County,West Virginia,46803,1031,4311,18234,8096,3587,6934,4610,41461,11544
54035,Jackson County,West Virginia,19840,1033,880,7973,3805,2454,2400,1295,17927,3695
54037,Jefferson County,West Virginia,40367,1160,2731,11954,8216,3318,8119,4869,36476,12988
54039,Kanawha County,West Virginia,130252,3784,8454,47043,24934,9348,21682,15007,118014,36689
54041,Lewis County,West Virginia,12133,531,953,5639,2068,806,1338,798,10649,2136
54043,Lincoln County,West Virginia,14448,968,1606,6829,2678,1200,765,402,11874,1167
54045,Logan County,West Virginia,23284,1143,3267,10215,3922,1647,1638,1452,18874,3090
54047,McDowell County,West Virginia,13790,1114,1989,7334,1922,514,666,251,10687,917
54049,Marion County,West Virginia,38618,996,2333,15398,7062,3148,6088,3593,35289,9681
54051,Marshall County,West Virginia,22710,203,1512,9503,4587,2581,2793,1531,20995,4324
54053,Mason County,West Virginia,18410,1032,1626,7787,3030,2086,1919,930,15752,2849
54055,Mercer County,West Virginia,42048,1909,3809,16167,8448,3064,5675,2976,36330,8651
54057,Mineral County,West Virginia,19384,166,1011,8602,3027,2108,2356,2114,18207,4470
54059,Mingo County,West Virginia,16663,1323,2571,7412,2658,1106,935,658,12769,1593
54061,Monongalia County,West Virginia,65027,1138,2827,16123,9247,4301,14220,17171,61062,31391
54063,Monroe County,West Virginia,8964,468,560,4603,1463,505,877,488,7936,1365
54065,Morgan County,West Virginia,13060,375,1163,5596,2407,1077,1296,1146,11522,2442
54067,Nicholas County,West Virginia,17841,608,1342,8248,3244,1111,1646,1642,15891,3288
54069,Ohio County,West Virginia,29835,458,1626,9694,5556,2602,6073,3826,27751,9899
54071,Pendleton County,West Virginia,4653,294,491,2230,565,178,674,221,3868,895
54073,Pleasants County,West Virginia,5430,176,494,2692,1035,378,342,313,4760,655
54075,Pocahontas County,West Virginia,5994,201,807,2843,841,417,512,373,4986,885
54077,Preston County,West Virginia,25566,1161,2223,11906,4572,1213,2866,1625,22182,4491
54079,Putnam County,West Virginia,40561,895,1689,14200,8055,3742,7241,4739,37977,11980
54081,Raleigh County,West Virginia,52795,2141,5633,19837,10339,3995,6485,4365,45021,10850
54083,Randolph County,West Virginia,20533,921,1608,10328,3007,1049,2501,1119,18004,3620
54085,Ritchie County,West Virginia,6234,448,578,3055,912,473,592,176,5208,768
54087,Roane County,West Virginia,10110,683,1275,4827,1309,639,917,460,8152,1377
54089,Summers County,West Virginia,9424,750,871,3953,1907,384,980,579,7803,1559
54091,Taylor County,West Virginia,12187,354,1231,5044,2489,833,1514,722,10602,2236
54093,Tucker County,West Virginia,5388,208,390,2168,968,316,738,600,4790,1338
54095,Tyler County,West Virginia,6182,282,278,2899,1091,619,685,328,5622,1013
54097,Upshur County,West Virginia,16418,780,1298,8281,2288,1038,1564,1169,14340,2733
54099,Wayne County,West Virginia,28006,1146,3276,10450,5450,2555,2872,2257,23584,5129
54101,Webster County,West Virginia,6181,638,603,3027,963,239,549,162,4940,711
54103,Wetzel County,West Virginia,10305,287,746,4990,1870,1027,940,445,9272,1385
54105,Wirt County,West Virginia,3848,191,354,1747,745,228,395,188,3303,583
54107,Wood County,West Virginia,60316,1487,4016,21276,13392,6856,8131,5158,54813,13289
54109,Wyoming County,West Virginia,15447,1209,2437,7203,1913,920,947,818,11801,1765
55001,Adams County,Wisconsin,16596,409,1524,6791,3853,1426,1895,698,14663,2593
55003,Ashland County,Wisconsin,11136,127,421,4012,2667,1607,1464,838,10588,2302
55005,Barron County,Wisconsin,33242,1172,1952,11812,6543,4871,4654,2238,30118,6892
55007,Bayfield County,Wisconsin,12545,129,396,3415,2797,1597,2627,1584,12020,4211
55009,Brown County,Wisconsin,180495,5457,7405,53240,34545,22565,40059,17224,167633,57283
55011,Buffalo County,Wisconsin,9747,196,596,3927,1668,1313,1470,577,8955,2047
55013,Burnett County,Wisconsin,12836,203,734,4908,2735,1421,1936,899,11899,2835
55015,Calumet County,Wisconsin,36408,590,1291,11378,6598,5007,8314,3230,34527,11544
55017,Chippewa County,Wisconsin,47131,1014,2430,16251,9678,6821,8001,2936,43687,10937
55019,Clark County,Wisconsin,21563,2458,1383,8437,4076,2381,2056,772,17722,2828
55021,Columbia County,Wisconsin,41753,844,1704,13372,10310,5425,6969,3129,39205,10098
55023,Crawford County,Wisconsin,11782,275,691,4840,2451,1461,1485,579,10816,2064
55025,Dane County,Wisconsin,370892,5784,9031,64928,57454,33466,120419,79810,356077,200229
55027,Dodge County,Wisconsin,64480,1560,3454,26157,13426,7264,8945,3674,59466,12619
55029,Door County,Wisconsin,23483,269,723,6368,5669,2174,5399,2881,22491,8280
55031,Douglas County,Wisconsin,31727,389,1388,9282,7518,4519,6063,2568,29950,8631
55033,Dunn County,Wisconsin,27990,452,1206,9145,5637,3555,5172,2823,26332,7995
55035,Eau Claire County,Wisconsin,67365,1082,1566,17568,13166,10156,15550,8277,64717,23827
55037,Florence County,Wisconsin,3607,78,232,1301,798,386,609,203,3297,812
55039,Fond du Lac County,Wisconsin,73005,1512,3996,27041,14970,9204,10940,5342,67497,16282
55041,Forest County,Wisconsin,6785,135,526,2671,1649,736,850,218,6124,1068
55043,Grant County,Wisconsin,32525,1245,1207,10966,6425,4807,4873,3002,30073,7875
55045,Green County,Wisconsin,26479,605,1187,8938,5363,3462,4624,2300,24687,6924
55047,Green Lake County,Wisconsin,13502,397,809,5079,2990,1199,1965,1063,12296,3028
55049,Iowa County,Wisconsin,16888,256,508,5660,3661,2116,3202,1485,16124,4687
55051,Iron County,Wisconsin,4938,27,160,1630,1225,724,824,348,4751,1172
55053,Jackson County,Wisconsin,14912,359,863,6533,3097,1692,1585,783,13690,2368
55055,Jefferson County,Wisconsin,59485,1885,2434,19430,12884,6272,11621,4959,55166,16580
55057,Juneau County,Wisconsin,19700,421,1673,7819,4345,2267,2219,956,17606,3175
55059,Kenosha County,Wisconsin,114537,4252,5736,32047,26915,11894,21475,12218,104549,33693
55061,Kewaunee County,Wisconsin,14666,302,562,5761,2900,2170,2105,866,13802,2971
55063,La Crosse County,Wisconsin,77996,1195,1728,19619,17199,10295,17046,10914,75073,27960
55065,Lafayette County,Wisconsin,11369,486,507,4573,2175,1368,1563,697,10376,2260
55067,Langlade County,Wisconsin,14333,381,1094,5956,3009,1624,1592,677,12858,2269
55069,Lincoln County,Wisconsin,21396,580,1093,9096,4201,2409,2726,1291,19723,4017
55071,Manitowoc County,Wisconsin,58590,1517,2844,21720,12019,6958,9562,3970,54229,13532
55073,Marathon County,Wisconsin,96076,2970,4036,31711,18171,13203,17895,8090,89070,25985
55075,Marinette County,Wisconsin,31233,796,1628,12049,6891,4285,3792,1792,28809,5584
55077,Marquette County,Wisconsin,11727,221,774,5145,2684,1208,1232,463,10732,1695
55078,Menominee County,Wisconsin,2488,37,75,1071,552,282,307,164,2376,471
55079,Milwaukee County,Wisconsin,620640,24165,41012,175703,123680,50744,130326,75010,555463,205336
55081,Monroe County,Wisconsin,31206,1406,1426,11521,6908,3670,4317,1958,28374,6275
55083,Oconto County,Wisconsin,28774,484,1697,11761,5807,4034,3830,1161,26593,4991
55085,Oneida County,Wisconsin,29073,269,1080,8943,7296,3612,4915,2958,27724,7873
55087,Outagamie County,Wisconsin,130100,2642,4847,40097,24465,16995,28991,12063,122611,41054
55089,Ozaukee County,Wisconsin,64467,397,1101,13964,11583,5317,19850,12255,62969,32105
55091,Pepin County,Wisconsin,5276,135,189,1975,1087,686,888,316,4952,1204
55093,Pierce County,Wisconsin,26847,228,974,8226,5732,3358,5592,2737,25645,8329
55095,Polk County,Wisconsin,32988,423,1736,11654,7304,4364,5217,2290,30829,7507
55097,Portage County,Wisconsin,45814,784,1663,14133,7960,5878,10749,4647,43367,15396
55099,Price County,Wisconsin,10709,150,611,4493,2293,1439,1205,518,9948,1723
55101,Racine County,Wisconsin,135029,3958,7878,39498,31221,14667,25327,12480,123193,37807
55103,Richland County,Wisconsin,12336,492,603,5177,2259,1346,1693,766,11241,2459
55105,Rock County,Wisconsin,112361,2737,5968,38418,24822,13011,18465,8940,103656,27405
55107,Rusk County,Wisconsin,10386,242,683,4268,1990,1425,1243,535,9461,1778
55109,St. Croix County,Wisconsin,63874,597,1840,15666,13069,8570,16833,7299,61437,24132
55111,Sauk County,Wisconsin,46152,1192,2407,15429,9780,5733,8152,3459,42553,11611
55113,Sawyer County,Wisconsin,13693,236,750,4468,3036,1517,2348,1338,12707,3686
55115,Shawano County,Wisconsin,29299,696,1625,12593,5297,3764,3661,1663,26978,5324
55117,Sheboygan County,Wisconsin,82149,1646,3429,27890,17248,10051,14669,7216,77074,21885
55119,Taylor County,Wisconsin,13904,519,965,6199,2589,1431,1581,620,12420,2201
55121,Trempealeau County,Wisconsin,20775,702,1013,7926,3876,3171,2838,1249,19060,4087
55123,Vernon County,Wisconsin,20660,1172,831,7244,3902,2487,3309,1715,18657,5024
55125,Vilas County,Wisconsin,18135,186,650,5715,4381,1914,3433,1856,17299,5289
55127,Walworth County,Wisconsin,70518,1942,3751,21439,15028,6633,14460,7265,64825,21725
55129,Washburn County,Wisconsin,12605,259,589,4369,2929,1546,2045,868,11757,2913
55131,Washington County,Wisconsin,97348,963,3707,28624,19137,11876,22631,10410,92678,33041
55133,Waukesha County,Wisconsin,289847,2695,6440,60501,54960,28522,90538,46191,280712,136729
55135,Waupaca County,Wisconsin,37712,727,1981,16518,7057,4094,5234,2101,35004,7335
55137,Waushara County,Wisconsin,18695,673,1351,7856,3957,1772,2121,965,16671,3086
55139,Winnebago County,Wisconsin,116103,1979,4712,37102,23895,14363,23496,10556,109412,34052
55141,Wood County,Wisconsin,52948,1012,2554,20237,10393,7464,7590,3698,49382,11288
56001,Albany County,Wyoming,21101,247,479,3037,3833,1701,6073,5731,20375,11804
56003,Big Horn County,Wyoming,7954,285,659,2249,2169,960,1149,483,7010,1632
56005,Campbell County,Wyoming,30249,955,1458,10146,7718,3343,4219,2410,27836,6629
56007,Carbon County,Wyoming,10146,329,675,3781,2297,927,1639,498,9142,2137
56009,Converse County,Wyoming,9500,276,460,3211,2262,1205,1231,855,8764,2086
56011,Crook County,Wyoming,5065,22,277,1484,1377,726,1021,158,4766,1179
56013,Fremont County,Wyoming,26286,273,1531,8258,6792,3057,3990,2385,24482,6375
56015,Goshen County,Wyoming,8911,219,378,2465,2564,1149,1374,762,8314,2136
56017,Hot Springs County,Wyoming,3308,28,134,867,916,429,682,252,3146,934
56019,Johnson County,Wyoming,6336,219,239,1580,1732,550,1222,794,5878,2016
56021,Laramie County,Wyoming,68410,1265,2603,17030,17355,9299,13178,7680,64542,20858
56023,Lincoln County,Wyoming,13207,153,624,4010,3664,1706,2048,1002,12430,3050
56025,Natrona County,Wyoming,53977,806,2376,14986,14623,6838,8817,5531,50795,14348
56027,Niobrara County,Wyoming,1882,55,97,715,508,130,334,43,1730,377
56029,Park County,Wyoming,21506,239,749,5494,4618,3361,4669,2376,20518,7045
56031,Platte County,Wyoming,6572,141,283,2191,1737,766,788,666,6148,1454
56033,Sheridan County,Wyoming,22046,238,576,6854,5250,2045,4174,2909,21232,7083
56035,Sublette County,Wyoming,6184,27,229,1734,1927,685,1193,389,5928,1582
56037,Sweetwater County,Wyoming,27594,657,1262,9010,7128,4023,3413,2101,25675,5514
56039,Teton County,Wyoming,17873,421,300,2976,2993,407,6945,3831,17152,10776
56041,Uinta County,Wyoming,13274,283,465,4821,3639,1530,1796,740,12526,2536
56043,Washakie County,Wyoming,5521,79,213,1571,1908,583,732,435,5229,1167
56045,Weston County,Wyoming,4900,99,336,1807,1133,662,626,237,4465,863
72001,Adjuntas Municipio,Puerto Rico,13115,2759,1386,4155,1006,1667,1818,324,8970,2142
72003,Aguada Municipio,Puerto Rico,28576,6845,2630,7299,2257,3390,4796,1359,19101,6155
72005,Aguadilla Municipio,Puerto Rico,40147,5950,3723,12584,4686,3274,6828,3102,30474,9930
72007,Aguas Buenas Municipio,Puerto Rico,17285,2764,1765,5727,1736,1914,2772,607,12756,3379
72009,Aibonito Municipio,Puerto Rico,18353,2327,1374,6616,2112,1776,2740,1408,14652,4148
72011,Añasco Municipio,Puerto Rico,19078,3863,1486,5745,1347,2501,3177,959,13729,4136
72013,Arecibo Municipio,Puerto Rico,64464,8359,4829,19735,8221,6566,13042,3712,51276,16754
72015,Arroyo Municipio,Puerto Rico,11341,1317,1164,3336,1394,1308,2249,573,8860,2822
72017,Barceloneta Municipio,Puerto Rico,16451,2521,1140,5541,1750,1696,2955,848,12790,3803
72019,Barranquitas Municipio,Puerto Rico,20173,2560,1836,6164,2953,2163,3715,782,15777,4497
72021,Bayamón Municipio,Puerto Rico,136936,13816,8875,31721,24467,15873,30918,11266,114245,42184
72023,Cabo Rojo Municipio,Puerto Rico,35227,5470,3011,8531,4585,3740,7381,2509,26746,9890
72025,Caguas Municipio,Puerto Rico,93442,8662,5775,24918,12227,9724,21992,10144,79005,32136
72027,Camuy Municipio,Puerto Rico,24290,4576,2276,5857,2027,4377,3630,1547,17438,5177
72029,Canóvanas Municipio,Puerto Rico,30544,3799,2420,8777,3605,3921,5549,2473,24325,8022
72031,Carolina Municipio,Puerto Rico,114434,8208,5848,30676,14670,16053,28572,10407,100378,38979
72033,Cataño Municipio,Puerto Rico,16783,2338,1389,5759,1826,1820,2675,976,13056,3651
72035,Cayey Municipio,Puerto Rico,30794,4809,1818,9930,3424,2251,6118,2444,24167,8562
72037,Ceiba Municipio,Puerto Rico,8410,1106,670,3019,888,872,1502,353,6634,1855
72039,Ciales Municipio,Puerto Rico,12489,2656,1376,3697,1622,1151,1635,352,8457,1987
72041,Cidra Municipio,Puerto Rico,29002,4397,1589,9587,2802,3075,5441,2111,23016,7552
72043,Coamo Municipio,Puerto Rico,25766,3130,1412,10341,2596,2358,4568,1361,21224,5929
72045,Comerío Municipio,Puerto Rico,13877,2609,1283,3990,2507,1252,1715,521,9985,2236
72047,Corozal Municipio,Puerto Rico,24749,4010,2130,7003,3583,2834,3979,1210,18609,5189
72049,Culebra Municipio,Puerto Rico,812,98,38,322,133,94,116,11,676,127
72051,Dorado Municipio,Puerto Rico,25622,2770,1641,6662,3694,2379,5841,2635,21211,8476
72053,Fajardo Municipio,Puerto Rico,23339,2359,1338,7830,2623,2335,5400,1454,19642,6854
72054,Florida Municipio,Puerto Rico,8080,1352,456,2910,962,895,1207,298,6272,1505
72055,Guánica Municipio,Puerto Rico,9758,1533,1322,3770,668,1094,1073,298,6903,1371
72057,Guayama Municipio,Puerto Rico,26104,3326,2288,9614,2743,2317,4067,1749,20490,5816
72059,Guayanilla Municipio,Puerto Rico,12786,1646,1099,3739,950,2243,2311,798,10041,3109
72061,Guaynabo Municipio,Puerto Rico,68776,6039,3341,12055,8230,6312,20524,12275,59396,32799
72063,Gurabo Municipio,Puerto Rico,29397,2875,1903,7238,4167,3273,6863,3078,24619,9941
72065,Hatillo Municipio,Puerto Rico,28771,4421,1950,6900,1830,5033,6175,2462,22400,8637
72067,Hormigueros Municipio,Puerto Rico,11972,1655,698,3934,1264,943,2685,793,9619,3478
72069,Humacao Municipio,Puerto Rico,37711,4413,3099,13274,3892,3899,6410,2724,30199,9134
72071,Isabela Municipio,Puerto Rico,31882,5424,2129,9896,2579,3771,6037,2046,24329,8083
72073,Jayuya Municipio,Puerto Rico,10416,1647,497,3938,1527,643,1669,495,8272,2164
72075,Juana Díaz Municipio,Puerto Rico,33053,4870,3010,9374,2992,3939,6531,2337,25173,8868
72077,Juncos Municipio,Puerto Rico,26306,3283,2088,7716,3956,3568,4370,1325,20935,5695
72079,Lajas Municipio,Puerto Rico,17473,3260,1655,4906,1954,2237,2767,694,12558,3461
72081,Lares Municipio,Puerto Rico,20841,4925,1926,4896,2250,2595,3105,1144,13990,4249
72083,Las Marías Municipio,Puerto Rico,6237,1575,584,2179,188,609,913,189,4078,1102
72085,Las Piedras Municipio,Puerto Rico,25698,3754,1274,6225,4268,3136,4930,2111,20670,7041
72087,Loíza Municipio,Puerto Rico,17127,2142,1740,6657,1524,2200,2398,466,13245,2864
72089,Luquillo Municipio,Puerto Rico,13012,1611,1008,4419,1518,1501,2065,890,10393,2955
72091,Manatí Municipio,Puerto Rico,28786,4555,2412,8857,3602,2511,5183,1666,21819,6849
72093,Maricao Municipio,Puerto Rico,3969,1227,379,1288,473,186,287,129,2363,416
72095,Maunabo Municipio,Puerto Rico,8052,1421,576,2514,1293,1135,744,369,6055,1113
72097,Mayagüez Municipio,Puerto Rico,49701,8093,4593,14147,5860,3462,9108,4438,37015,13546
72099,Moca Municipio,Puerto Rico,26947,5310,2291,8306,2637,2102,4718,1583,19346,6301
72101,Morovis Municipio,Puerto Rico,20557,3169,1733,6531,2483,2794,2995,852,15655,3847
72103,Naguabo Municipio,Puerto Rico,16479,2599,1120,6103,1039,1855,2789,974,12760,3763
72105,Naranjito Municipio,Puerto Rico,21238,3881,2137,5247,3434,2686,3020,833,15220,3853
72107,Orocovis Municipio,Puerto Rico,15272,2810,1490,4760,1791,1764,2111,546,10972,2657
72109,Patillas Municipio,Puerto Rico,12024,1737,710,3554,2165,1460,1571,827,9577,2398
72111,Peñuelas Municipio,Puerto Rico,14246,2456,1386,3790,968,2032,3102,512,10404,3614
72113,Ponce Municipio,Puerto Rico,98573,12953,7814,29325,9955,9035,20656,8835,77806,29491
72115,Quebradillas Municipio,Puerto Rico,17298,2788,1545,5026,1606,2716,2667,950,12965,3617
72117,Rincón Municipio,Puerto Rico,11750,2194,974,2948,1101,1791,2123,619,8582,2742
72119,Río Grande Municipio,Puerto Rico,34604,4245,2688,10605,3886,4391,7031,1758,27671,8789
72121,Sabana Grande Municipio,Puerto Rico,15918,2456,970,5521,1333,1588,3277,773,12492,4050
72123,Salinas Municipio,Puerto Rico,18419,2584,1524,7372,1732,1488,2879,840,14311,3719
72125,San Germán Municipio,Puerto Rico,23259,3873,2370,7862,1764,1958,4005,1427,17016,5432
72127,San Juan Municipio,Puerto Rico,253367,24920,14184,54578,26688,28244,62804,41949,214263,104753
72129,San Lorenzo Municipio,Puerto Rico,27831,5084,2504,7309,4180,3293,3661,1800,20243,5461
72131,San Sebastián Municipio,Puerto Rico,29132,5830,2909,7664,3257,3331,4713,1428,20393,6141
72133,Santa Isabel Municipio,Puerto Rico,14291,1583,826,5273,1507,1239,3005,858,11882,3863
72135,Toa Alta Municipio,Puerto Rico,48006,4772,2470,12741,5499,9151,10011,3362,40764,13373
72137,Toa Baja Municipio,Puerto Rico,54759,5757,3373,14304,8684,7681,11514,3446,45629,14960
72139,Trujillo Alto Municipio,Puerto Rico,49610,4483,2385,10500,7091,6068,13839,5244,42742,19083
72141,Utuado Municipio,Puerto Rico,20839,3910,1647,5500,3013,2130,3745,894,15282,4639
72143,Vega Alta Municipio,Puerto Rico,25230,3853,2054,7155,3252,3190,3834,1892,19323,5726
72145,Vega Baja Municipio,Puerto Rico,39853,5891,3376,11653,4734,4198,7638,2363,30586,10001
72147,Vieques Municipio,Puerto Rico,6017,796,872,2793,121,560,406,469,4349,875
72149,Villalba Municipio,Puerto Rico,15531,2341,933,5344,1753,1802,2742,616,12257,3358
72151,Yabucoa Municipio,Puerto Rico,22497,3513,2161,5824,4164,2688,3361,786,16823,4147
72153,Yauco Municipio,Puerto Rico,25439,3481,1849,8725,2023,2331,5376,1654,20109,7030
